"matchID","Q1_s","Q2_s","Q3_s","Q4_s","gameDuration_s"
"2008-03-20_R1_Carlton-v-Richmond",1791,1867,1676,1793,7127
"2008-03-20_R1_Port Adelaide-v-Geelong",1963,1797,1861,1828,7449
"2008-03-22_R1_Collingwood-v-Fremantle",1789,1793,1717,1846,7145
"2008-03-22_R1_St Kilda-v-Sydney",1736,1611,1589,1572,6508
"2008-03-22_R1_West Coast-v-Brisbane Lions",1850,1624,1847,1768,7089
"2008-03-23_R1_Hawthorn-v-Melbourne",1806,1566,1850,1994,7216
"2008-03-23_R1_Western Bulldogs-v-Adelaide",1703,1669,1946,2050,7368
"2008-03-24_R1_North Melbourne-v-Essendon",1824,1796,1809,1711,7140
"2008-03-28_R2_Brisbane Lions-v-Collingwood",1688,1862,1924,1891,7365
"2008-03-29_R2_Adelaide-v-West Coast",1761,1635,1718,1820,6934
"2008-03-29_R2_Fremantle-v-Hawthorn",1739,1862,1903,1824,7328
"2008-03-29_R2_Melbourne-v-Western Bulldogs",1644,1793,1849,1722,7008
"2008-03-29_R2_St Kilda-v-Carlton",1741,1842,1624,2030,7237
"2008-03-30_R2_Geelong-v-Essendon",1709,1842,1748,1772,7071
"2008-03-30_R2_Richmond-v-North Melbourne",1996,1874,1804,1598,7272
"2008-03-30_R2_Sydney-v-Port Adelaide",1983,1832,1909,1897,7621
"2008-04-04_R3_Western Bulldogs-v-St Kilda",1797,1942,1852,1983,7574
"2008-04-05_R3_Brisbane Lions-v-Sydney",1699,1767,1609,1625,6700
"2008-04-05_R3_Essendon-v-Carlton",2003,1810,2112,1709,7634
"2008-04-05_R3_North Melbourne-v-Hawthorn",1779,1872,1820,1791,7262
"2008-04-05_R3_West Coast-v-Fremantle",1787,1655,1594,1602,6638
"2008-04-06_R3_Adelaide-v-Port Adelaide",1635,1987,1908,1875,7405
"2008-04-06_R3_Geelong-v-Melbourne",1733,1759,1775,1592,6859
"2008-04-06_R3_Richmond-v-Collingwood",1695,1910,1863,1681,7149
"2008-04-11_R4_Essendon-v-Western Bulldogs",1673,2088,1987,1783,7531
"2008-04-12_R4_North Melbourne-v-Melbourne",1764,1858,1821,1956,7399
"2008-04-12_R4_Port Adelaide-v-Brisbane Lions",1787,1707,1856,2065,7415
"2008-04-12_R4_St Kilda-v-Geelong",1779,1991,1892,1793,7455
"2008-04-12_R4_Sydney-v-West Coast",1798,1731,1749,1892,7170
"2008-04-13_R4_Carlton-v-Collingwood",1981,1730,1550,1935,7196
"2008-04-13_R4_Fremantle-v-Richmond",1997,1726,1661,1814,7198
"2008-04-13_R4_Hawthorn-v-Adelaide",1680,1720,1868,1786,7054
"2008-04-18_R5_St Kilda-v-Essendon",1889,2006,1857,1789,7541
"2008-04-19_R5_Adelaide-v-Fremantle",1586,1642,1692,1854,6774
"2008-04-19_R5_Brisbane Lions-v-Hawthorn",1812,2024,1960,1776,7572
"2008-04-19_R5_Collingwood-v-North Melbourne",1700,1891,1651,2089,7331
"2008-04-19_R5_Geelong-v-Sydney",1739,1802,1692,2086,7319
"2008-04-20_R5_Melbourne-v-Carlton",1623,1872,1485,1800,6780
"2008-04-20_R5_West Coast-v-Port Adelaide",1827,1880,1829,1959,7495
"2008-04-20_R5_Western Bulldogs-v-Richmond",1851,1909,1815,2016,7591
"2008-04-25_R6_Collingwood-v-Essendon",1918,1777,1769,2061,7525
"2008-04-25_R6_Fremantle-v-Geelong",1709,2022,1702,1881,7314
"2008-04-26_R6_Carlton-v-Adelaide",1729,1762,1798,1884,7173
"2008-04-26_R6_Port Adelaide-v-St Kilda",1713,1792,1857,1736,7098
"2008-04-26_R6_Western Bulldogs-v-West Coast",1859,1691,1768,1577,6895
"2008-04-27_R6_Brisbane Lions-v-Melbourne",1692,1946,1832,2006,7476
"2008-04-27_R6_Hawthorn-v-Richmond",1806,1677,1828,1761,7072
"2008-04-27_R6_North Melbourne-v-Sydney",1753,1649,1835,1785,7022
"2008-05-02_R7_West Coast-v-Carlton",1675,1869,1922,1952,7418
"2008-05-03_R7_Adelaide-v-North Melbourne",1679,1931,1819,1813,7242
"2008-05-03_R7_Geelong-v-Brisbane Lions",1868,1650,1798,1776,7092
"2008-05-03_R7_Hawthorn-v-Collingwood",1741,1684,2024,1902,7351
"2008-05-03_R7_Richmond-v-St Kilda",1823,1913,1967,1894,7597
"2008-05-04_R7_Essendon-v-Port Adelaide",1857,1973,1853,1750,7433
"2008-05-04_R7_Melbourne-v-Fremantle",1751,1782,1921,2061,7515
"2008-05-04_R7_Sydney-v-Western Bulldogs",1870,1875,1873,1988,7606
"2008-05-16_R8_St Kilda-v-Collingwood",1987,1778,1832,1669,7266
"2008-05-17_R8_Carlton-v-Brisbane Lions",1863,1715,2039,1781,7398
"2008-05-17_R8_Hawthorn-v-Port Adelaide",1882,1919,1940,1642,7383
"2008-05-17_R8_North Melbourne-v-West Coast",1875,1827,1687,1645,7034
"2008-05-17_R8_Richmond-v-Geelong",1632,1663,1820,1702,6817
"2008-05-18_R8_Adelaide-v-Melbourne",2017,1773,1778,1992,7560
"2008-05-18_R8_Fremantle-v-Western Bulldogs",1956,1686,1731,1830,7203
"2008-05-18_R8_Sydney-v-Essendon",1799,1881,1914,1958,7552
"2008-05-23_R9_Collingwood-v-Geelong",1852,1743,1782,1669,7046
"2008-05-24_R9_Carlton-v-Fremantle",1779,1770,1894,1542,6985
"2008-05-24_R9_Essendon-v-Richmond",1729,1750,1969,1758,7206
"2008-05-24_R9_Port Adelaide-v-Sydney",2181,1757,1642,1997,7577
"2008-05-24_R9_West Coast-v-Adelaide",1586,1721,1733,1796,6836
"2008-05-25_R9_Brisbane Lions-v-St Kilda",1686,1836,2013,2013,7548
"2008-05-25_R9_Melbourne-v-Hawthorn",1731,1620,1935,1793,7079
"2008-05-25_R9_Western Bulldogs-v-North Melbourne",1938,1820,1795,1805,7358
"2008-05-30_R10_Adelaide-v-Essendon",1673,1783,1703,1708,6867
"2008-05-31_R10_Brisbane Lions-v-North Melbourne",1770,2022,2027,1857,7676
"2008-05-31_R10_Collingwood-v-West Coast",1730,2064,1758,1906,7458
"2008-05-31_R10_Geelong-v-Carlton",1647,1899,1842,1882,7270
"2008-05-31_R10_Hawthorn-v-Western Bulldogs",1670,2046,1760,1717,7193
"2008-06-01_R10_Fremantle-v-Port Adelaide",1718,1895,1807,1811,7231
"2008-06-01_R10_St Kilda-v-Melbourne",1752,1803,1626,1979,7160
"2008-06-01_R10_Sydney-v-Richmond",1792,1835,1662,1865,7154
"2008-06-06_R11_North Melbourne-v-Geelong",1816,2197,2181,1755,7949
"2008-06-07_R11_Essendon-v-Hawthorn",1784,1815,1849,1731,7179
"2008-06-07_R11_Richmond-v-Adelaide",2075,1580,1934,1793,7382
"2008-06-07_R11_West Coast-v-Sydney",1789,1645,1604,2025,7063
"2008-06-08_R11_Brisbane Lions-v-Fremantle",1647,1753,1707,1690,6797
"2008-06-08_R11_Port Adelaide-v-Carlton",1751,1852,1683,2179,7465
"2008-06-08_R11_St Kilda-v-Western Bulldogs",1659,1913,1692,1908,7172
"2008-06-09_R11_Melbourne-v-Collingwood",1881,1938,1964,1623,7406
"2008-06-13_R12_Essendon-v-West Coast",1802,1845,1748,1866,7261
"2008-06-14_R12_Adelaide-v-Hawthorn",1603,1798,1766,1623,6790
"2008-06-14_R12_Fremantle-v-North Melbourne",1776,1711,1699,1884,7070
"2008-06-14_R12_Sydney-v-St Kilda",1682,1779,1838,1633,6932
"2008-06-14_R12_Western Bulldogs-v-Brisbane Lions",1790,1791,1841,1931,7353
"2008-06-15_R12_Collingwood-v-Carlton",1701,1803,2017,1994,7515
"2008-06-15_R12_Geelong-v-Port Adelaide",1760,1843,1742,1703,7048
"2008-06-15_R12_Richmond-v-Melbourne",1770,1970,1745,1645,7130
"2008-06-20_R13_St Kilda-v-Fremantle",1792,1679,1720,1453,6644
"2008-06-21_R13_Brisbane Lions-v-Adelaide",1622,1761,1790,1714,6887
"2008-06-21_R13_Hawthorn-v-North Melbourne",1627,1881,1579,1884,6971
"2008-06-21_R13_Port Adelaide-v-Richmond",2053,1828,1885,1694,7460
"2008-06-21_R13_West Coast-v-Geelong",1852,1711,1985,1762,7310
"2008-06-22_R13_Carlton-v-Essendon",2099,1693,1797,2071,7660
"2008-06-22_R13_Collingwood-v-Western Bulldogs",1603,1783,2064,1666,7116
"2008-06-22_R13_Melbourne-v-Sydney",1873,1660,1761,1878,7172
"2008-06-27_R14_Hawthorn-v-West Coast",1682,1938,1727,1689,7036
"2008-06-28_R14_North Melbourne-v-St Kilda",1656,1636,1700,1905,6897
"2008-06-28_R14_Richmond-v-Carlton",1520,1814,1881,1827,7042
"2008-06-28_R14_Western Bulldogs-v-Port Adelaide",1661,1973,1879,1750,7263
"2008-06-29_R14_Fremantle-v-Essendon",1686,1877,1690,1838,7091
"2008-06-29_R14_Melbourne-v-Brisbane Lions",1804,1649,1674,2150,7277
"2008-07-04_R14_Adelaide-v-Geelong",1758,1766,1643,1950,7117
"2008-07-05_R14_Sydney-v-Collingwood",1608,1557,1801,1883,6849
"2008-07-11_R15_Carlton-v-St Kilda",1597,2019,1845,1936,7397
"2008-07-12_R15_Collingwood-v-Adelaide",1814,1850,1825,1790,7279
"2008-07-12_R15_Essendon-v-Brisbane Lions",1954,1781,1963,1981,7679
"2008-07-12_R15_Geelong-v-Fremantle",1965,1604,1810,1673,7052
"2008-07-12_R15_Port Adelaide-v-North Melbourne",1907,1675,1852,1710,7144
"2008-07-13_R15_Hawthorn-v-Sydney",1799,1949,1715,1928,7391
"2008-07-13_R15_West Coast-v-Richmond",1654,1950,1869,1866,7339
"2008-07-13_R15_Western Bulldogs-v-Melbourne",1599,1763,1628,1637,6627
"2008-07-18_R16_North Melbourne-v-Collingwood",1604,1782,2011,1795,7192
"2008-07-19_R16_Brisbane Lions-v-West Coast",1918,1857,1714,1605,7094
"2008-07-19_R16_Geelong-v-Western Bulldogs",1742,1922,1803,1892,7359
"2008-07-19_R16_Richmond-v-Essendon",1740,1834,1749,1805,7128
"2008-07-19_R16_St Kilda-v-Hawthorn",1782,1839,1924,1834,7379
"2008-07-20_R16_Carlton-v-Sydney",1764,2056,2000,1752,7572
"2008-07-20_R16_Fremantle-v-Melbourne",1745,1797,1828,1768,7138
"2008-07-20_R16_Port Adelaide-v-Adelaide",1954,1856,1726,1994,7530
"2008-07-25_R17_Hawthorn-v-Geelong",1903,1721,1684,1778,7086
"2008-07-26_R17_Essendon-v-Collingwood",1768,1729,1775,1920,7192
"2008-07-26_R17_Richmond-v-Brisbane Lions",1695,1867,1862,1997,7421
"2008-07-26_R17_Sydney-v-Adelaide",1703,1855,1494,1633,6685
"2008-07-26_R17_West Coast-v-St Kilda",1687,1729,1757,1930,7103
"2008-07-27_R17_Melbourne-v-North Melbourne",1823,1611,1749,1779,6962
"2008-07-27_R17_Port Adelaide-v-Fremantle",1718,1877,2098,1876,7569
"2008-07-27_R17_Western Bulldogs-v-Carlton",1623,1809,1811,1642,6885
"2008-08-01_R18_Collingwood-v-Hawthorn",1768,1688,1871,1736,7063
"2008-08-02_R18_Adelaide-v-Carlton",1718,2070,1903,1534,7225
"2008-08-02_R18_Essendon-v-Melbourne",1640,1966,1785,1882,7273
"2008-08-02_R18_Geelong-v-Richmond",1614,1726,1976,1771,7087
"2008-08-02_R18_North Melbourne-v-Brisbane Lions",1850,1818,1705,1653,7026
"2008-08-03_R18_Fremantle-v-West Coast",1919,1699,1889,1483,6990
"2008-08-03_R18_St Kilda-v-Port Adelaide",1838,1875,1796,1971,7480
"2008-08-03_R18_Western Bulldogs-v-Sydney",1993,1947,1661,1880,7481
"2008-08-08_R19_Melbourne-v-Geelong",1777,1634,1900,1849,7160
"2008-08-09_R19_Carlton-v-Port Adelaide",1646,1648,1761,1874,6929
"2008-08-09_R19_Collingwood-v-St Kilda",1777,1510,1915,1826,7028
"2008-08-09_R19_Hawthorn-v-Brisbane Lions",1591,1544,1695,2059,6889
"2008-08-09_R19_Sydney-v-Fremantle",1690,1928,1825,1877,7320
"2008-08-10_R19_Adelaide-v-Richmond",1642,1755,1900,1596,6893
"2008-08-10_R19_North Melbourne-v-Western Bulldogs",1832,1703,1920,2002,7457
"2008-08-10_R19_West Coast-v-Essendon",1861,1654,1762,1986,7263
"2008-08-15_R20_Port Adelaide-v-Collingwood",1990,1878,1844,1675,7387
"2008-08-16_R20_Brisbane Lions-v-Western Bulldogs",1842,1691,1650,1884,7067
"2008-08-16_R20_Essendon-v-Adelaide",1633,1828,1872,1915,7248
"2008-08-16_R20_Melbourne-v-West Coast",1568,1605,1565,1755,6493
"2008-08-16_R20_Sydney-v-Geelong",2080,1768,1869,1976,7693
"2008-08-17_R20_Carlton-v-North Melbourne",2088,1989,1626,1770,7473
"2008-08-17_R20_Fremantle-v-St Kilda",1673,1651,1886,1652,6862
"2008-08-17_R20_Richmond-v-Hawthorn",1742,1766,1666,1702,6876
"2008-08-22_R21_Western Bulldogs-v-Essendon",1705,1937,2006,1847,7495
"2008-08-23_R21_Brisbane Lions-v-Carlton",1937,1739,1878,1807,7361
"2008-08-23_R21_Collingwood-v-Sydney",1951,1667,1663,1903,7184
"2008-08-23_R21_Port Adelaide-v-Melbourne",1716,1592,1711,1890,6909
"2008-08-23_R21_Richmond-v-Fremantle",1798,1912,1621,1597,6928
"2008-08-24_R21_Geelong-v-North Melbourne",1788,1896,1813,1768,7265
"2008-08-24_R21_St Kilda-v-Adelaide",1610,1832,1626,1728,6796
"2008-08-24_R21_West Coast-v-Hawthorn",1720,1874,1997,1730,7321
"2008-08-29_R22_Fremantle-v-Collingwood",1721,1634,1752,1661,6768
"2008-08-30_R22_Adelaide-v-Western Bulldogs",1749,1790,1664,1671,6874
"2008-08-30_R22_Carlton-v-Hawthorn",2240,1738,1857,1989,7824
"2008-08-30_R22_Geelong-v-West Coast",1922,1949,1904,1821,7596
"2008-08-30_R22_North Melbourne-v-Port Adelaide",1732,1960,1803,1723,7218
"2008-08-30_R22_Sydney-v-Brisbane Lions",1823,1757,1769,1734,7083
"2008-08-31_R22_Essendon-v-St Kilda",1910,1638,1737,1659,6944
"2008-08-31_R22_Melbourne-v-Richmond",1637,1740,1645,1787,6809
"2008-09-05_RQualifying_Hawthorn-v-Western Bulldogs",1755,1913,1964,1719,7351
"2008-09-06_RElimination_Collingwood-v-Adelaide",1800,1861,1900,1785,7346
"2008-09-06_RElimination_Sydney-v-North Melbourne",1794,1798,2010,1745,7347
"2008-09-07_RQualifying_Geelong-v-St Kilda",1865,1737,2140,1576,7318
"2008-09-12_RSemi_Western Bulldogs-v-Sydney",1701,1880,1739,1876,7196
"2008-09-13_RSemi_St Kilda-v-Collingwood",1871,1667,1803,1726,7067
"2008-09-19_RPreliminary_Geelong-v-Western Bulldogs",1886,1668,1646,1531,6731
"2008-09-20_RPreliminary_Hawthorn-v-St Kilda",1729,1796,1788,1740,7053
"2008-09-27_RGrand_Hawthorn-v-Geelong",2099,1831,1882,1898,7710
"2009-03-26_R1_Richmond-v-Carlton",2071,1844,1811,1788,7514
"2009-03-27_R1_Hawthorn-v-Geelong",1853,1986,1866,1882,7587
"2009-03-28_R1_Brisbane Lions-v-West Coast",1819,1779,1999,1639,7236
"2009-03-28_R1_Collingwood-v-Adelaide",1805,1993,1850,1715,7363
"2009-03-28_R1_St Kilda-v-Sydney",1857,1668,1875,1878,7278
"2009-03-29_R1_Fremantle-v-Western Bulldogs",2019,1927,1939,1882,7767
"2009-03-29_R1_Melbourne-v-North Melbourne",1814,1755,1814,1743,7126
"2009-03-29_R1_Port Adelaide-v-Essendon",1673,1718,1839,1657,6887
"2009-04-03_R2_Adelaide-v-St Kilda",1796,1734,2088,1860,7478
"2009-04-04_R2_Carlton-v-Brisbane Lions",1734,1828,1903,1956,7421
"2009-04-04_R2_Collingwood-v-Melbourne",1735,1674,1875,1671,6955
"2009-04-04_R2_Geelong-v-Richmond",1744,1793,2014,1774,7325
"2009-04-04_R2_Sydney-v-Hawthorn",1975,1916,2189,2069,8149
"2009-04-05_R2_Essendon-v-Fremantle",1740,1860,1984,1488,7072
"2009-04-05_R2_West Coast-v-Port Adelaide",1744,1879,2006,1758,7387
"2009-04-05_R2_Western Bulldogs-v-North Melbourne",1693,1661,1849,1687,6890
"2009-04-09_R3_Geelong-v-Collingwood",1788,1861,1757,1926,7332
"2009-04-11_R3_Brisbane Lions-v-Sydney",1807,2049,1810,1884,7550
"2009-04-11_R3_Carlton-v-Essendon",1685,1907,2104,1766,7462
"2009-04-11_R3_St Kilda-v-West Coast",1738,1966,1993,1798,7495
"2009-04-12_R3_Fremantle-v-Adelaide",1942,1937,1900,1944,7723
"2009-04-12_R3_North Melbourne-v-Hawthorn",1902,2070,1996,1880,7848
"2009-04-12_R3_Port Adelaide-v-Melbourne",1703,1825,1915,2051,7494
"2009-04-13_R3_Western Bulldogs-v-Richmond",1654,1907,1842,1813,7216
"2009-04-17_R4_Brisbane Lions-v-Collingwood",1808,1944,1694,1644,7090
"2009-04-18_R4_Adelaide-v-Geelong",1880,1918,1878,1850,7526
"2009-04-18_R4_Hawthorn-v-Port Adelaide",1786,1665,1804,1978,7233
"2009-04-18_R4_St Kilda-v-Fremantle",1718,1646,1745,1702,6811
"2009-04-18_R4_Sydney-v-Carlton",1835,1741,1813,1750,7139
"2009-04-19_R4_North Melbourne-v-Essendon",1617,1711,1862,1719,6909
"2009-04-19_R4_Richmond-v-Melbourne",1628,1925,1801,1710,7064
"2009-04-19_R4_West Coast-v-Western Bulldogs",1993,1839,1983,1808,7623
"2009-04-24_R5_Port Adelaide-v-St Kilda",1916,1837,1868,1846,7467
"2009-04-25_R5_Essendon-v-Collingwood",1729,1819,1873,1864,7285
"2009-04-25_R5_Fremantle-v-Sydney",1991,2049,2142,1943,8125
"2009-04-25_R5_Hawthorn-v-West Coast",1773,1728,1710,1844,7055
"2009-04-25_R5_North Melbourne-v-Richmond",1811,1598,1654,1710,6773
"2009-04-26_R5_Melbourne-v-Adelaide",1548,1715,1791,1747,6801
"2009-04-26_R5_Western Bulldogs-v-Carlton",1767,2060,1727,1861,7415
"2009-05-01_R6_North Melbourne-v-Collingwood",1985,2034,1717,1750,7486
"2009-05-02_R6_Brisbane Lions-v-Essendon",1759,1858,1624,1813,7054
"2009-05-02_R6_Hawthorn-v-Carlton",1851,1848,1819,2036,7554
"2009-05-02_R6_Port Adelaide-v-Adelaide",1621,1864,1826,1854,7165
"2009-05-02_R6_West Coast-v-Fremantle",1849,1581,1826,1877,7133
"2009-05-03_R6_Melbourne-v-Geelong",1774,1809,1677,1715,6975
"2009-05-03_R6_Sydney-v-Richmond",1775,1799,1769,1755,7098
"2009-05-03_R6_Western Bulldogs-v-St Kilda",1733,1824,1789,1781,7127
"2009-05-08_R7_Essendon-v-Hawthorn",1817,1748,1917,1727,7209
"2009-05-09_R7_Carlton-v-Fremantle",1784,2004,1592,1732,7112
"2009-05-09_R7_Geelong-v-Sydney",1677,1955,1967,1961,7560
"2009-05-09_R7_North Melbourne-v-Port Adelaide",1946,1900,2091,2239,8176
"2009-05-09_R7_Richmond-v-Brisbane Lions",1738,1767,1889,1803,7197
"2009-05-10_R7_Adelaide-v-Western Bulldogs",1817,1752,1826,1912,7307
"2009-05-10_R7_West Coast-v-Melbourne",1630,1999,1812,1572,7013
"2009-05-11_R7_Collingwood-v-St Kilda",1766,1772,1899,1842,7279
"2009-05-15_R8_Fremantle-v-Hawthorn",1701,1768,1995,1680,7144
"2009-05-16_R8_Brisbane Lions-v-Adelaide",1864,1695,1802,1829,7190
"2009-05-16_R8_Geelong-v-North Melbourne",1745,1998,1871,1598,7212
"2009-05-16_R8_Melbourne-v-Western Bulldogs",1817,1965,1628,1753,7163
"2009-05-16_R8_Sydney-v-West Coast",1945,1709,2063,1931,7648
"2009-05-17_R8_Collingwood-v-Carlton",1724,1638,1974,1841,7177
"2009-05-17_R8_Port Adelaide-v-Richmond",1824,1676,1909,1826,7235
"2009-05-17_R8_St Kilda-v-Essendon",1702,1666,1762,1771,6901
"2009-05-22_R9_Geelong-v-Western Bulldogs",1897,2039,1809,1987,7732
"2009-05-23_R9_Adelaide-v-Carlton",1703,1801,1968,1931,7403
"2009-05-23_R9_North Melbourne-v-Fremantle",1887,1878,1740,1534,7039
"2009-05-23_R9_Richmond-v-Essendon",1833,1800,1823,1768,7224
"2009-05-23_R9_West Coast-v-Collingwood",1841,1794,1728,1970,7333
"2009-05-24_R9_Hawthorn-v-Melbourne",1769,1736,1802,1652,6959
"2009-05-24_R9_St Kilda-v-Brisbane Lions",1604,1914,1919,1903,7340
"2009-05-24_R9_Sydney-v-Port Adelaide",1806,1760,1797,2064,7427
"2009-05-29_R10_Carlton-v-West Coast",1859,1675,1649,1777,6960
"2009-05-30_R10_Fremantle-v-Richmond",1968,1626,1934,1983,7511
"2009-05-30_R10_North Melbourne-v-Brisbane Lions",1944,1793,1712,1740,7189
"2009-05-30_R10_St Kilda-v-Melbourne",1980,1735,1642,1539,6896
"2009-05-30_R10_Western Bulldogs-v-Sydney",1938,1790,1884,1936,7548
"2009-05-31_R10_Adelaide-v-Hawthorn",1925,1770,1738,1879,7312
"2009-05-31_R10_Collingwood-v-Port Adelaide",1877,1792,1906,1677,7252
"2009-05-31_R10_Essendon-v-Geelong",1882,1802,1842,1850,7376
"2009-06-05_R11_Richmond-v-Western Bulldogs",1847,2161,1785,1881,7674
"2009-06-06_R11_Brisbane Lions-v-Carlton",1761,1876,1924,1920,7481
"2009-06-06_R11_North Melbourne-v-St Kilda",1925,1863,1862,1890,7540
"2009-06-06_R11_Port Adelaide-v-Fremantle",2130,1861,1759,1629,7379
"2009-06-07_R11_Essendon-v-Adelaide",1856,2042,2018,1910,7826
"2009-06-07_R11_Hawthorn-v-Sydney",1921,1671,1760,1856,7208
"2009-06-07_R11_West Coast-v-Geelong",1701,1712,1865,1685,6963
"2009-06-08_R11_Melbourne-v-Collingwood",1791,1890,1817,1621,7119
"2009-06-12_R12_Carlton-v-St Kilda",1993,1731,1798,1917,7439
"2009-06-13_R12_Richmond-v-West Coast",1793,1792,1795,1685,7065
"2009-06-13_R12_Western Bulldogs-v-Port Adelaide",1724,1798,1850,1965,7337
"2009-06-14_R12_Hawthorn-v-Brisbane Lions",1747,1706,1761,1839,7053
"2009-06-19_R12_Essendon-v-Melbourne",1911,1848,1810,1700,7269
"2009-06-20_R12_Sydney-v-Collingwood",1880,1750,1814,1851,7295
"2009-06-21_R12_Fremantle-v-Geelong",1676,1914,1809,1865,7264
"2009-06-26_R13_Essendon-v-Carlton",1736,2063,1816,1940,7555
"2009-06-27_R13_Adelaide-v-Sydney",1567,1816,2008,1834,7225
"2009-06-27_R13_Brisbane Lions-v-Melbourne",1704,1747,1595,1821,6867
"2009-06-27_R13_Collingwood-v-Fremantle",1797,1731,2107,1870,7505
"2009-06-27_R13_West Coast-v-Hawthorn",2043,2014,1914,2123,8094
"2009-06-28_R13_Geelong-v-Port Adelaide",1927,1766,1813,1741,7247
"2009-06-28_R13_North Melbourne-v-Western Bulldogs",1986,1738,1813,1734,7271
"2009-06-28_R13_St Kilda-v-Richmond",1703,1642,1835,1628,6808
"2009-07-03_R14_Collingwood-v-Essendon",1644,1867,1852,1672,7035
"2009-07-04_R14_Melbourne-v-West Coast",1885,1946,1803,1586,7220
"2009-07-04_R14_Port Adelaide-v-Brisbane Lions",1664,1889,1924,1909,7386
"2009-07-04_R14_Richmond-v-Adelaide",1857,1790,1797,1607,7051
"2009-07-04_R14_Western Bulldogs-v-Hawthorn",1921,1784,1759,1804,7268
"2009-07-05_R14_Fremantle-v-Carlton",1837,1862,1758,1895,7352
"2009-07-05_R14_St Kilda-v-Geelong",1843,1858,1720,2059,7480
"2009-07-05_R14_Sydney-v-North Melbourne",1851,1885,1692,1949,7377
"2009-07-10_R15_Western Bulldogs-v-Collingwood",1890,1804,1882,1868,7444
"2009-07-11_R15_Brisbane Lions-v-Geelong",1779,1874,1723,1596,6972
"2009-07-11_R15_Carlton-v-Richmond",1892,2082,1743,1830,7547
"2009-07-11_R15_Sydney-v-Essendon",1868,1699,1808,1742,7117
"2009-07-12_R15_Hawthorn-v-North Melbourne",1799,1750,1923,1858,7330
"2009-07-12_R15_Melbourne-v-Port Adelaide",1701,1931,1739,1755,7126
"2009-07-12_R15_West Coast-v-St Kilda",1913,1766,1951,1860,7490
"2009-07-17_R16_Essendon-v-Western Bulldogs",1759,1735,1735,1799,7028
"2009-07-18_R16_Carlton-v-Sydney",1727,1703,2055,2019,7504
"2009-07-18_R16_Collingwood-v-Hawthorn",1785,1858,1985,1930,7558
"2009-07-18_R16_Fremantle-v-Brisbane Lions",1755,1818,1942,1762,7277
"2009-07-18_R16_Geelong-v-Melbourne",1837,1590,1909,1741,7077
"2009-07-19_R16_Port Adelaide-v-West Coast",1978,1919,1967,1937,7801
"2009-07-19_R16_Richmond-v-North Melbourne",1826,1992,1816,1814,7448
"2009-07-19_R16_St Kilda-v-Adelaide",1961,1739,1690,1572,6962
"2009-07-24_R17_Carlton-v-Collingwood",1789,1687,1527,1759,6762
"2009-07-25_R17_Brisbane Lions-v-North Melbourne",1824,1670,1857,1640,6991
"2009-07-25_R17_Fremantle-v-West Coast",1766,1918,1616,2005,7305
"2009-07-25_R17_Geelong-v-Hawthorn",1858,1832,1975,1914,7579
"2009-07-25_R17_St Kilda-v-Western Bulldogs",1772,1783,1710,1826,7091
"2009-07-26_R17_Adelaide-v-Port Adelaide",1746,1833,1990,1910,7479
"2009-07-26_R17_Essendon-v-Richmond",1780,1860,1798,1836,7274
"2009-07-26_R17_Melbourne-v-Sydney",1675,1598,1732,1729,6734
"2009-07-31_R18_North Melbourne-v-Carlton",1859,1679,1932,1619,7089
"2009-08-01_R18_Collingwood-v-Brisbane Lions",1836,1749,1731,1762,7078
"2009-08-01_R18_Geelong-v-Adelaide",1866,1653,1894,1825,7238
"2009-08-01_R18_Sydney-v-St Kilda",1864,2043,1771,2074,7752
"2009-08-01_R18_Western Bulldogs-v-Fremantle",1683,1903,1705,1767,7058
"2009-08-02_R18_Melbourne-v-Richmond",1678,1705,1760,1883,7026
"2009-08-02_R18_Port Adelaide-v-Hawthorn",1930,2211,1714,1795,7650
"2009-08-02_R18_West Coast-v-Essendon",1757,1789,1744,1814,7104
"2009-08-07_R19_Carlton-v-Geelong",1733,1848,1727,1561,6869
"2009-08-08_R19_Adelaide-v-Collingwood",1735,1598,1761,1882,6976
"2009-08-08_R19_Essendon-v-Brisbane Lions",1814,1735,1829,1684,7062
"2009-08-08_R19_Hawthorn-v-St Kilda",1955,1850,1733,1733,7271
"2009-08-08_R19_Western Bulldogs-v-West Coast",1654,2114,1873,1706,7347
"2009-08-09_R19_Fremantle-v-Port Adelaide",2011,1821,1890,1685,7407
"2009-08-09_R19_North Melbourne-v-Melbourne",1896,1627,1870,1744,7137
"2009-08-09_R19_Richmond-v-Sydney",1967,1753,1937,1726,7383
"2009-08-14_R20_Hawthorn-v-Adelaide",1841,1905,2106,1666,7518
"2009-08-15_R20_Brisbane Lions-v-Western Bulldogs",1886,1928,1815,1792,7421
"2009-08-15_R20_Richmond-v-Collingwood",1962,1936,1870,1737,7505
"2009-08-15_R20_Sydney-v-Geelong",1680,1889,1759,1874,7202
"2009-08-15_R20_West Coast-v-North Melbourne",1705,1906,1976,1798,7385
"2009-08-16_R20_Essendon-v-St Kilda",1915,1806,1966,1764,7451
"2009-08-16_R20_Melbourne-v-Fremantle",1902,1743,1663,1811,7119
"2009-08-16_R20_Port Adelaide-v-Carlton",1847,1873,1838,2051,7609
"2009-08-21_R21_Western Bulldogs-v-Geelong",1735,1791,1824,1793,7143
"2009-08-22_R21_Adelaide-v-West Coast",1834,1892,1748,1724,7198
"2009-08-22_R21_Brisbane Lions-v-Port Adelaide",2216,2000,2067,1738,8021
"2009-08-22_R21_Carlton-v-Melbourne",1921,1842,1787,1725,7275
"2009-08-22_R21_Richmond-v-Hawthorn",1902,2027,1900,2084,7913
"2009-08-23_R21_Collingwood-v-Sydney",1599,1830,1721,1754,6904
"2009-08-23_R21_Fremantle-v-Essendon",1750,1844,1965,1991,7550
"2009-08-23_R21_St Kilda-v-North Melbourne",2031,1758,1740,1951,7480
"2009-08-28_R22_West Coast-v-Richmond",1947,2172,1798,1633,7550
"2009-08-29_R22_Carlton-v-Adelaide",2113,1973,1918,1800,7804
"2009-08-29_R22_Geelong-v-Fremantle",1809,1805,1789,1659,7062
"2009-08-29_R22_Hawthorn-v-Essendon",1899,1879,2107,1991,7876
"2009-08-29_R22_Port Adelaide-v-North Melbourne",1879,1848,1802,1632,7161
"2009-08-29_R22_Sydney-v-Brisbane Lions",1983,2026,1907,1906,7822
"2009-08-30_R22_Collingwood-v-Western Bulldogs",1660,1825,1952,1591,7028
"2009-08-30_R22_Melbourne-v-St Kilda",1725,1732,1687,1842,6986
"2009-09-04_RElimination_Adelaide-v-Essendon",1879,1979,1987,1948,7793
"2009-09-05_RElimination_Brisbane Lions-v-Carlton",2099,1951,1905,1945,7900
"2009-09-05_RQualifying_Geelong-v-Western Bulldogs",1783,1676,1879,1656,6994
"2009-09-06_RQualifying_St Kilda-v-Collingwood",1614,1781,1721,1766,6882
"2009-09-11_RSemi_Western Bulldogs-v-Brisbane Lions",1664,1771,1890,1909,7234
"2009-09-12_RSemi_Collingwood-v-Adelaide",2014,1629,1686,1878,7207
"2009-09-18_RPreliminary_St Kilda-v-Western Bulldogs",1605,1801,1964,1796,7166
"2009-09-19_RPreliminary_Geelong-v-Collingwood",1792,2046,1730,1692,7260
"2009-09-26_RGrand_Geelong-v-St Kilda",1836,1927,1899,1797,7459
"2010-03-25_R1_Richmond-v-Carlton",1957,1826,1805,1622,7210
"2010-03-26_R1_Geelong-v-Essendon",1663,2045,1935,1969,7612
"2010-03-27_R1_Brisbane Lions-v-West Coast",1735,1843,1835,2023,7436
"2010-03-27_R1_Melbourne-v-Hawthorn",2028,1721,1863,1713,7325
"2010-03-27_R1_Sydney-v-St Kilda",1909,1863,1869,2074,7715
"2010-03-28_R1_Fremantle-v-Adelaide",1756,1935,1919,1891,7501
"2010-03-28_R1_Port Adelaide-v-North Melbourne",1925,1887,1956,1896,7664
"2010-03-28_R1_Western Bulldogs-v-Collingwood",1969,2043,1859,1937,7808
"2010-04-01_R2_Brisbane Lions-v-Carlton",1905,1916,1876,1762,7459
"2010-04-03_R2_Collingwood-v-Melbourne",1755,1877,1845,1789,7266
"2010-04-03_R2_St Kilda-v-North Melbourne",1961,1748,1899,1817,7425
"2010-04-03_R2_West Coast-v-Port Adelaide",1839,2219,1987,2171,8216
"2010-04-04_R2_Adelaide-v-Sydney",1870,1895,1794,1777,7336
"2010-04-04_R2_Essendon-v-Fremantle",1839,1941,1899,1838,7517
"2010-04-04_R2_Richmond-v-Western Bulldogs",1835,1735,1851,1667,7088
"2010-04-05_R2_Hawthorn-v-Geelong",1901,1703,1822,1879,7305
"2010-04-09_R3_St Kilda-v-Collingwood",1806,1818,2015,1697,7336
"2010-04-10_R3_Carlton-v-Essendon",1917,1767,1643,1926,7253
"2010-04-10_R3_North Melbourne-v-West Coast",2006,1744,1939,1618,7307
"2010-04-10_R3_Port Adelaide-v-Brisbane Lions",1863,1876,2052,1804,7595
"2010-04-10_R3_Sydney-v-Richmond",1801,1714,1798,2047,7360
"2010-04-11_R3_Fremantle-v-Geelong",1834,2001,1977,2142,7954
"2010-04-11_R3_Melbourne-v-Adelaide",1646,1559,2054,1580,6839
"2010-04-11_R3_Western Bulldogs-v-Hawthorn",1811,2055,1738,1907,7511
"2010-04-16_R4_West Coast-v-Essendon",2090,2007,1735,1881,7713
"2010-04-17_R4_Adelaide-v-Carlton",1831,2005,1591,1794,7221
"2010-04-17_R4_Brisbane Lions-v-Western Bulldogs",1719,1906,2152,1711,7488
"2010-04-17_R4_Collingwood-v-Hawthorn",1815,1881,1703,2158,7557
"2010-04-17_R4_North Melbourne-v-Sydney",1779,1953,1875,1707,7314
"2010-04-18_R4_Geelong-v-Port Adelaide",1931,1771,2180,1772,7654
"2010-04-18_R4_Richmond-v-Melbourne",2131,1720,1853,1898,7602
"2010-04-18_R4_St Kilda-v-Fremantle",1938,1769,1995,1749,7451
"2010-04-23_R5_Western Bulldogs-v-Adelaide",1874,1835,1813,1549,7071
"2010-04-24_R5_Melbourne-v-Brisbane Lions",1921,1870,1902,1682,7375
"2010-04-24_R5_Port Adelaide-v-St Kilda",1719,1757,1713,1943,7132
"2010-04-24_R5_Sydney-v-West Coast",1778,1781,1786,1998,7343
"2010-04-25_R5_Collingwood-v-Essendon",1944,1830,1835,1533,7142
"2010-04-25_R5_Fremantle-v-Richmond",1835,1766,2089,1862,7552
"2010-04-25_R5_Hawthorn-v-North Melbourne",1847,1815,1935,1868,7465
"2010-04-26_R5_Carlton-v-Geelong",1790,1825,1786,1650,7051
"2010-04-30_R6_Western Bulldogs-v-St Kilda",1739,1573,1640,1639,6591
"2010-05-01_R6_Adelaide-v-Port Adelaide",1831,1896,1865,1861,7453
"2010-05-01_R6_Essendon-v-Hawthorn",1856,1790,1959,1766,7371
"2010-05-01_R6_North Melbourne-v-Melbourne",1810,1718,1899,1776,7203
"2010-05-01_R6_Sydney-v-Brisbane Lions",1765,1844,2220,1721,7550
"2010-05-02_R6_Carlton-v-Collingwood",1749,1980,1994,1987,7710
"2010-05-02_R6_Geelong-v-Richmond",1744,1986,1914,1865,7509
"2010-05-02_R6_West Coast-v-Fremantle",1943,1999,1917,2057,7916
"2010-05-07_R7_Melbourne-v-Western Bulldogs",1842,1662,1843,1726,7073
"2010-05-08_R7_Brisbane Lions-v-Fremantle",2042,1751,1830,1969,7592
"2010-05-08_R7_Collingwood-v-North Melbourne",1883,1883,2042,1871,7679
"2010-05-08_R7_Essendon-v-Port Adelaide",1799,1964,2144,1914,7821
"2010-05-08_R7_West Coast-v-Hawthorn",1814,2094,1974,2100,7982
"2010-05-09_R7_Adelaide-v-Richmond",2083,1805,1600,1949,7437
"2010-05-09_R7_Geelong-v-Sydney",1828,1789,1936,1966,7519
"2010-05-10_R7_St Kilda-v-Carlton",1799,1832,1833,1895,7359
"2010-05-14_R8_Fremantle-v-Collingwood",2014,1985,1923,1904,7826
"2010-05-15_R8_Brisbane Lions-v-Geelong",1814,1833,2046,1739,7432
"2010-05-15_R8_Melbourne-v-West Coast",1714,1817,1752,1617,6900
"2010-05-15_R8_North Melbourne-v-Adelaide",1729,1738,1784,1785,7036
"2010-05-15_R8_Western Bulldogs-v-Sydney",1923,1795,1772,1654,7144
"2010-05-16_R8_Port Adelaide-v-Carlton",1896,1930,2075,1901,7802
"2010-05-16_R8_Richmond-v-Hawthorn",1804,1931,1755,1864,7354
"2010-05-16_R8_St Kilda-v-Essendon",1751,1861,1773,1928,7313
"2010-05-21_R9_Collingwood-v-Geelong",1656,1674,1901,1763,6994
"2010-05-22_R9_Essendon-v-Richmond",1898,1802,1834,1964,7498
"2010-05-22_R9_Melbourne-v-Port Adelaide",1720,1744,1813,2173,7450
"2010-05-22_R9_North Melbourne-v-Western Bulldogs",1800,1877,1891,1681,7249
"2010-05-22_R9_Sydney-v-Fremantle",1751,1940,1778,1858,7327
"2010-05-23_R9_Adelaide-v-Brisbane Lions",1915,1780,1781,2028,7504
"2010-05-23_R9_Carlton-v-Hawthorn",1906,1752,1905,1813,7376
"2010-05-23_R9_West Coast-v-St Kilda",1726,1931,1889,1828,7374
"2010-05-28_R10_Essendon-v-Western Bulldogs",1666,1814,1843,1917,7240
"2010-05-29_R10_Brisbane Lions-v-Collingwood",1951,1591,1743,1745,7030
"2010-05-29_R10_Geelong-v-Melbourne",1931,1693,1816,1707,7147
"2010-05-29_R10_St Kilda-v-Adelaide",1814,1802,1925,1789,7330
"2010-05-30_R10_Carlton-v-West Coast",1813,1782,1843,1749,7187
"2010-05-30_R10_Fremantle-v-North Melbourne",1952,1723,2154,1766,7595
"2010-05-30_R10_Hawthorn-v-Sydney",1687,1765,1852,2013,7317
"2010-06-04_R11_Richmond-v-St Kilda",1631,1928,1773,1549,6881
"2010-06-05_R11_Adelaide-v-Fremantle",2100,2075,1712,1739,7626
"2010-06-05_R11_Carlton-v-Melbourne",2020,1733,1958,1800,7511
"2010-06-05_R11_North Melbourne-v-Brisbane Lions",2037,1820,1766,1774,7397
"2010-06-05_R11_West Coast-v-Geelong",1892,1875,2164,1839,7770
"2010-06-06_R11_Collingwood-v-Western Bulldogs",1657,1849,2047,1831,7384
"2010-06-06_R11_Hawthorn-v-Port Adelaide",1606,1861,1671,1766,6904
"2010-06-06_R11_Sydney-v-Essendon",1814,1855,1841,1945,7455
"2010-06-11_R12_North Melbourne-v-Carlton",1821,1859,1861,1768,7309
"2010-06-12_R12_Essendon-v-Geelong",1936,1909,1791,1963,7599
"2010-06-12_R12_Hawthorn-v-Adelaide",2016,1766,1918,1888,7588
"2010-06-12_R12_Port Adelaide-v-Sydney",1812,1847,1740,1857,7256
"2010-06-13_R12_Fremantle-v-St Kilda",1828,1893,1792,1753,7266
"2010-06-13_R12_Richmond-v-West Coast",1847,1716,1931,1799,7293
"2010-06-13_R12_Western Bulldogs-v-Brisbane Lions",1816,1700,1779,1656,6951
"2010-06-14_R12_Melbourne-v-Collingwood",1894,1669,1573,1782,6918
"2010-06-18_R13_Hawthorn-v-Essendon",1860,1759,1714,1958,7291
"2010-06-19_R13_Brisbane Lions-v-Richmond",1802,1820,1784,1804,7210
"2010-06-19_R13_Carlton-v-Fremantle",1703,1765,1995,1962,7425
"2010-06-20_R13_North Melbourne-v-Port Adelaide",1752,1642,2032,1930,7356
"2010-06-20_R13_West Coast-v-Western Bulldogs",1801,1821,1801,1853,7276
"2010-06-25_R13_St Kilda-v-Geelong",1611,1845,1830,1601,6887
"2010-06-26_R13_Sydney-v-Collingwood",1773,1885,1826,1871,7355
"2010-06-27_R13_Adelaide-v-Melbourne",1932,1836,1824,1831,7423
"2010-07-01_R14_Carlton-v-Brisbane Lions",1791,1799,1882,1874,7346
"2010-07-02_R14_Hawthorn-v-Western Bulldogs",1782,1739,1721,1939,7181
"2010-07-03_R14_Adelaide-v-Essendon",1999,2067,1690,1810,7566
"2010-07-03_R14_Collingwood-v-West Coast",1623,1707,2086,1594,7010
"2010-07-03_R14_Fremantle-v-Port Adelaide",1882,1951,1670,1836,7339
"2010-07-04_R14_Geelong-v-North Melbourne",1841,1814,1732,1704,7091
"2010-07-04_R14_Richmond-v-Sydney",1693,1764,1842,1826,7125
"2010-07-04_R14_St Kilda-v-Melbourne",1811,1973,1801,1693,7278
"2010-07-09_R15_Port Adelaide-v-Collingwood",1772,1986,1842,1748,7348
"2010-07-10_R15_Brisbane Lions-v-St Kilda",1802,1585,1863,1857,7107
"2010-07-10_R15_Geelong-v-Hawthorn",1872,1772,1889,1956,7489
"2010-07-10_R15_Richmond-v-Fremantle",2015,1709,1646,1881,7251
"2010-07-10_R15_West Coast-v-Adelaide",1792,2007,1851,2125,7775
"2010-07-11_R15_Carlton-v-Western Bulldogs",1739,1895,1782,1654,7070
"2010-07-11_R15_Melbourne-v-Essendon",1969,1781,1843,2053,7646
"2010-07-11_R15_Sydney-v-North Melbourne",1915,1915,1632,1847,7309
"2010-07-16_R16_Adelaide-v-Geelong",1759,1609,1939,1768,7075
"2010-07-17_R16_Collingwood-v-St Kilda",1810,1787,1763,1922,7282
"2010-07-17_R16_Essendon-v-West Coast",1764,1966,1892,1864,7486
"2010-07-17_R16_Hawthorn-v-Brisbane Lions",1943,1886,1994,1615,7438
"2010-07-17_R16_Western Bulldogs-v-Port Adelaide",1749,1897,1736,1690,7072
"2010-07-18_R16_Carlton-v-Sydney",1789,1813,1935,1820,7357
"2010-07-18_R16_Fremantle-v-Melbourne",1958,1839,1844,1675,7316
"2010-07-18_R16_Richmond-v-North Melbourne",1729,1977,1728,1874,7308
"2010-07-23_R17_St Kilda-v-Hawthorn",1976,1959,1971,1883,7789
"2010-07-24_R17_Collingwood-v-Richmond",1761,1746,1762,1718,6987
"2010-07-24_R17_Geelong-v-Brisbane Lions",1682,1845,1902,1664,7093
"2010-07-24_R17_North Melbourne-v-Essendon",1878,1859,1861,2004,7602
"2010-07-24_R17_West Coast-v-Carlton",1650,1941,2004,2085,7680
"2010-07-25_R17_Melbourne-v-Sydney",1949,1866,1965,1820,7600
"2010-07-25_R17_Port Adelaide-v-Adelaide",1729,1855,1933,1942,7459
"2010-07-25_R17_Western Bulldogs-v-Fremantle",1902,1765,1822,1839,7328
"2010-07-30_R18_Essendon-v-St Kilda",2001,1660,1704,1946,7311
"2010-07-31_R18_Brisbane Lions-v-Melbourne",1725,1812,1903,1618,7058
"2010-07-31_R18_Collingwood-v-Carlton",1810,1801,1581,1958,7150
"2010-07-31_R18_Port Adelaide-v-Hawthorn",1936,2034,1769,1711,7450
"2010-07-31_R18_Sydney-v-Geelong",1837,1791,1891,1774,7293
"2010-08-01_R18_Fremantle-v-West Coast",1868,2075,1908,1918,7769
"2010-08-01_R18_Richmond-v-Adelaide",1789,1853,1908,1883,7433
"2010-08-01_R18_Western Bulldogs-v-North Melbourne",1919,1758,1809,2020,7506
"2010-08-06_R19_Essendon-v-Carlton",1874,1907,1737,1950,7468
"2010-08-07_R19_Geelong-v-Collingwood",1928,2001,1874,1567,7370
"2010-08-07_R19_North Melbourne-v-Fremantle",1833,1893,1809,1670,7205
"2010-08-07_R19_Sydney-v-Hawthorn",1910,1874,1962,1947,7693
"2010-08-07_R19_West Coast-v-Brisbane Lions",1610,1991,1724,1683,7008
"2010-08-08_R19_Adelaide-v-Western Bulldogs",1750,1791,1881,1735,7157
"2010-08-08_R19_Melbourne-v-Richmond",1767,1915,1720,1885,7287
"2010-08-08_R19_St Kilda-v-Port Adelaide",1685,1845,1963,1800,7293
"2010-08-13_R20_Essendon-v-Collingwood",1956,1830,1840,1827,7453
"2010-08-14_R20_Carlton-v-Richmond",1835,1845,1865,2005,7550
"2010-08-14_R20_Fremantle-v-Sydney",1760,1859,2138,1941,7698
"2010-08-14_R20_Port Adelaide-v-West Coast",1767,1793,1898,1814,7272
"2010-08-14_R20_Western Bulldogs-v-Geelong",1858,1917,1734,1925,7434
"2010-08-15_R20_Brisbane Lions-v-Adelaide",1948,1970,1950,1710,7578
"2010-08-15_R20_Hawthorn-v-Melbourne",1896,1951,1790,1741,7378
"2010-08-15_R20_North Melbourne-v-St Kilda",1780,1919,1816,1764,7279
"2010-08-20_R21_Geelong-v-Carlton",1940,1856,1706,1844,7346
"2010-08-21_R21_Collingwood-v-Adelaide",1773,1542,1628,1744,6687
"2010-08-21_R21_Hawthorn-v-Fremantle",1755,1861,1779,1928,7323
"2010-08-21_R21_St Kilda-v-Richmond",2005,1970,1751,1880,7606
"2010-08-21_R21_Sydney-v-Western Bulldogs",1995,1956,1900,1824,7675
"2010-08-22_R21_Essendon-v-Brisbane Lions",1834,1655,1695,1860,7044
"2010-08-22_R21_Port Adelaide-v-Melbourne",1765,1875,2081,1710,7431
"2010-08-22_R21_West Coast-v-North Melbourne",1907,1856,1917,2023,7703
"2010-08-27_R22_Fremantle-v-Carlton",1912,1837,1828,1982,7559
"2010-08-28_R22_Adelaide-v-St Kilda",1751,1608,1877,1638,6874
"2010-08-28_R22_Brisbane Lions-v-Sydney",1871,1962,1813,1867,7513
"2010-08-28_R22_Geelong-v-West Coast",1649,1795,1829,1857,7130
"2010-08-28_R22_Hawthorn-v-Collingwood",1654,1912,2060,2113,7739
"2010-08-28_R22_Western Bulldogs-v-Essendon",1887,1893,1628,1523,6931
"2010-08-29_R22_Melbourne-v-North Melbourne",1864,1911,1737,1753,7265
"2010-08-29_R22_Richmond-v-Port Adelaide",1779,1958,1881,2019,7637
"2010-09-03_RQualifying_St Kilda-v-Geelong",1837,1707,1797,1847,7188
"2010-09-04_RElimination_Fremantle-v-Hawthorn",1739,1824,1989,1791,7343
"2010-09-04_RQualifying_Collingwood-v-Western Bulldogs",1737,1937,1862,1966,7502
"2010-09-05_RElimination_Sydney-v-Carlton",2128,2141,1886,1852,8007
"2010-09-10_RSemi_Geelong-v-Fremantle",1888,1693,1858,1842,7281
"2010-09-11_RSemi_Western Bulldogs-v-Sydney",1790,1758,1697,1856,7101
"2010-09-17_RPreliminary_Collingwood-v-Geelong",1935,2010,1808,1739,7492
"2010-09-18_RPreliminary_St Kilda-v-Western Bulldogs",1760,1705,1844,1841,7150
"2010-09-25_RGrand_St Kilda-v-Collingwood",1851,1902,1896,1912,7561
"2010-10-02_RGrand_Collingwood-v-St Kilda",1686,1807,1959,1811,7263
"2011-03-24_R1_Carlton-v-Richmond",1762,1960,1799,1784,7305
"2011-03-25_R1_Geelong-v-St Kilda",2060,1623,1881,1711,7275
"2011-03-26_R1_Adelaide-v-Hawthorn",1789,1753,2042,1863,7447
"2011-03-26_R1_Brisbane Lions-v-Fremantle",1993,1916,1884,2016,7809
"2011-03-26_R1_Collingwood-v-Port Adelaide",1864,2078,2031,1820,7793
"2011-03-27_R1_Essendon-v-Western Bulldogs",1906,1950,1722,1626,7204
"2011-03-27_R1_Melbourne-v-Sydney",1849,1769,1801,1847,7266
"2011-03-27_R1_West Coast-v-North Melbourne",1948,1740,2040,1911,7639
"2011-04-01_R2_St Kilda-v-Richmond",1826,1951,1697,2151,7625
"2011-04-02_R2_Fremantle-v-Geelong",1937,1790,1647,1790,7164
"2011-04-02_R2_Gold Coast-v-Carlton",2020,1898,1965,1664,7547
"2011-04-02_R2_North Melbourne-v-Collingwood",1952,1711,1855,1838,7356
"2011-04-02_R2_Port Adelaide-v-West Coast",1812,2036,1914,1985,7747
"2011-04-03_R2_Hawthorn-v-Melbourne",1821,1793,2123,1795,7532
"2011-04-03_R2_Sydney-v-Essendon",1893,2013,1829,1890,7625
"2011-04-03_R2_Western Bulldogs-v-Brisbane Lions",1760,1790,1747,1830,7127
"2011-04-08_R3_Collingwood-v-Carlton",1786,1883,1674,1750,7093
"2011-04-09_R3_Adelaide-v-Fremantle",1820,1727,1703,1784,7034
"2011-04-09_R3_Richmond-v-Hawthorn",1923,1958,1788,1794,7463
"2011-04-09_R3_West Coast-v-Sydney",1908,1888,2023,2067,7886
"2011-04-10_R3_Geelong-v-Port Adelaide",1657,1739,1818,1887,7101
"2011-04-10_R3_Melbourne-v-Brisbane Lions",1773,1798,1947,1735,7253
"2011-04-10_R3_St Kilda-v-Essendon",2105,1844,1889,1856,7694
"2011-04-15_R4_Richmond-v-Collingwood",1963,1928,1892,1945,7728
"2011-04-16_R4_Carlton-v-Essendon",1952,1958,1660,1918,7488
"2011-04-16_R4_Hawthorn-v-West Coast",1687,1780,1674,1853,6994
"2011-04-16_R4_Port Adelaide-v-Adelaide",1799,2065,1736,1738,7338
"2011-04-16_R4_Sydney-v-Geelong",1943,1848,1836,1722,7349
"2011-04-17_R4_Fremantle-v-North Melbourne",2115,1878,2185,2005,8183
"2011-04-21_R5_Brisbane Lions-v-St Kilda",2070,1777,1763,1929,7539
"2011-04-23_R5_Carlton-v-Adelaide",1845,1879,1699,1732,7155
"2011-04-24_R5_North Melbourne-v-Richmond",1869,1896,1856,2039,7660
"2011-04-25_R5_Essendon-v-Collingwood",1706,1885,1957,1997,7545
"2011-04-25_R5_Fremantle-v-Western Bulldogs",1778,1969,1844,1976,7567
"2011-04-26_R5_Hawthorn-v-Geelong",2001,1621,2000,1903,7525
"2011-04-28_R6_West Coast-v-Melbourne",1722,1680,1792,1903,7097
"2011-04-29_R6_Sydney-v-Carlton",1948,1636,1943,1891,7418
"2011-04-30_R6_Adelaide-v-St Kilda",1905,1753,2077,1972,7707
"2011-04-30_R6_North Melbourne-v-Port Adelaide",1866,1744,1990,1961,7561
"2011-04-30_R6_Richmond-v-Brisbane Lions",1897,1775,2070,1789,7531
"2011-05-01_R6_Collingwood-v-Western Bulldogs",1816,1775,1968,1981,7540
"2011-05-06_R7_Port Adelaide-v-Hawthorn",1919,1842,1898,1743,7402
"2011-05-07_R7_Geelong-v-North Melbourne",1752,1775,1898,1624,7049
"2011-05-07_R7_Richmond-v-Fremantle",1710,2251,1900,1772,7633
"2011-05-07_R7_Western Bulldogs-v-Sydney",1875,1653,1747,1790,7065
"2011-05-08_R7_Essendon-v-West Coast",1912,1950,1920,1900,7682
"2011-05-08_R7_Melbourne-v-Adelaide",1814,1932,1980,2010,7736
"2011-05-09_R7_St Kilda-v-Carlton",1887,1927,1779,1791,7384
"2011-05-13_R8_Geelong-v-Collingwood",1791,1714,1957,1771,7233
"2011-05-14_R8_Adelaide-v-Gold Coast",1829,1911,2017,1836,7593
"2011-05-14_R8_Brisbane Lions-v-Essendon",1806,1862,1839,1903,7410
"2011-05-14_R8_North Melbourne-v-Melbourne",2111,1788,1967,1956,7822
"2011-05-14_R8_Sydney-v-Port Adelaide",1848,1697,2095,1746,7386
"2011-05-15_R8_Hawthorn-v-St Kilda",1674,1992,1689,1948,7303
"2011-05-15_R8_West Coast-v-Fremantle",1847,1858,1803,1808,7316
"2011-05-15_R8_Western Bulldogs-v-Richmond",1944,1872,1966,2129,7911
"2011-05-20_R9_Carlton-v-Geelong",1721,1876,1906,1748,7251
"2011-05-21_R9_Brisbane Lions-v-North Melbourne",1752,1778,1755,1743,7028
"2011-05-21_R9_Port Adelaide-v-Fremantle",1858,2044,2057,1894,7853
"2011-05-21_R9_Richmond-v-Essendon",1829,1995,2013,1847,7684
"2011-05-21_R9_St Kilda-v-Melbourne",1904,1704,1734,2069,7411
"2011-05-22_R9_Collingwood-v-Adelaide",1756,1732,2063,2046,7597
"2011-05-22_R9_Sydney-v-Hawthorn",1919,1570,2013,1830,7332
"2011-05-22_R9_West Coast-v-Western Bulldogs",1969,1909,1941,1883,7702
"2011-05-27_R10_Melbourne-v-Carlton",1768,1732,1867,1865,7232
"2011-05-28_R10_Fremantle-v-St Kilda",2062,1923,2194,2208,8387
"2011-05-28_R10_Gold Coast-v-Geelong",1974,1860,1929,1720,7483
"2011-05-28_R10_North Melbourne-v-Sydney",1734,1855,1730,1978,7297
"2011-05-28_R10_Richmond-v-Port Adelaide",1692,1790,2031,1945,7458
"2011-05-29_R10_Adelaide-v-Brisbane Lions",1736,1957,1815,1813,7321
"2011-05-29_R10_Collingwood-v-West Coast",1704,1759,1835,1820,7118
"2011-05-29_R10_Western Bulldogs-v-Hawthorn",1954,1707,1647,1790,7098
"2011-06-03_R11_Essendon-v-Melbourne",1761,1686,1759,1909,7115
"2011-06-04_R11_Brisbane Lions-v-Sydney",1808,1864,1808,1653,7133
"2011-06-04_R11_Collingwood-v-St Kilda",1802,1894,1783,1787,7266
"2011-06-04_R11_Geelong-v-Western Bulldogs",1871,1905,1656,2032,7464
"2011-06-05_R11_Hawthorn-v-Fremantle",1666,1825,2017,1967,7475
"2011-06-05_R11_North Melbourne-v-Adelaide",2133,1670,1898,1983,7684
"2011-06-05_R11_Port Adelaide-v-Carlton",1965,1687,1728,1872,7252
"2011-06-10_R12_St Kilda-v-Western Bulldogs",1823,1700,1609,1714,6846
"2011-06-11_R12_Adelaide-v-West Coast",1848,1928,1810,1953,7539
"2011-06-11_R12_Geelong-v-Hawthorn",1723,2008,1699,1889,7319
"2011-06-11_R12_Gold Coast-v-North Melbourne",1809,1707,1929,1849,7294
"2011-06-12_R12_Carlton-v-Brisbane Lions",1720,1690,1748,1892,7050
"2011-06-12_R12_Fremantle-v-Essendon",1912,1808,1759,1838,7317
"2011-06-12_R12_Sydney-v-Richmond",2029,1842,1724,1906,7501
"2011-06-13_R12_Melbourne-v-Collingwood",1789,1859,1776,1888,7312
"2011-06-17_R13_Western Bulldogs-v-Adelaide",1916,1692,1698,1709,7015
"2011-06-18_R13_Brisbane Lions-v-Richmond",1780,1921,1970,1877,7548
"2011-06-18_R13_Essendon-v-North Melbourne",1817,2125,2019,1818,7779
"2011-06-18_R13_Hawthorn-v-Gold Coast",1803,1616,1709,1845,6973
"2011-06-18_R13_St Kilda-v-Geelong",1832,1790,1824,1845,7291
"2011-06-19_R13_Carlton-v-Sydney",1843,1738,1724,1951,7256
"2011-06-19_R13_Melbourne-v-Fremantle",1792,1871,1810,1888,7361
"2011-06-19_R13_West Coast-v-Port Adelaide",1725,1956,1939,2002,7622
"2011-06-24_R14_Hawthorn-v-Essendon",1955,1825,1937,1801,7518
"2011-06-25_R14_Fremantle-v-Brisbane Lions",1780,1717,1789,1849,7135
"2011-06-25_R14_Gold Coast-v-Western Bulldogs",1912,1895,1750,1855,7412
"2011-06-25_R14_Richmond-v-Melbourne",1894,1970,1781,1811,7456
"2011-06-25_R14_Sydney-v-Collingwood",1959,1643,1975,1845,7422
"2011-06-26_R14_Carlton-v-West Coast",1659,1798,1891,1634,6982
"2011-06-26_R14_Geelong-v-Adelaide",1921,1643,1853,2048,7465
"2011-06-26_R14_Port Adelaide-v-North Melbourne",1959,2062,1886,1841,7748
"2011-07-01_R15_Western Bulldogs-v-Melbourne",1792,1843,1957,1869,7461
"2011-07-02_R15_Adelaide-v-Sydney",1779,1777,1777,1740,7073
"2011-07-02_R15_Essendon-v-Geelong",1869,1842,1951,2068,7730
"2011-07-02_R15_Fremantle-v-Gold Coast",1889,1874,2071,1679,7513
"2011-07-02_R15_Richmond-v-Carlton",1867,2017,2061,2139,8084
"2011-07-03_R15_Brisbane Lions-v-Port Adelaide",1767,1789,1966,1780,7302
"2011-07-03_R15_Collingwood-v-Hawthorn",1850,1765,1947,1750,7312
"2011-07-03_R15_North Melbourne-v-St Kilda",1723,1997,1734,1667,7121
"2011-07-08_R16_West Coast-v-Geelong",1957,1976,1917,1743,7593
"2011-07-09_R16_Essendon-v-Richmond",1937,1697,1916,1832,7382
"2011-07-09_R16_Hawthorn-v-Brisbane Lions",1829,1695,1877,1887,7288
"2011-07-10_R16_Collingwood-v-North Melbourne",1732,1863,2050,1706,7351
"2011-07-10_R16_Port Adelaide-v-St Kilda",1880,1815,1763,2038,7496
"2011-07-10_R16_Western Bulldogs-v-Carlton",1889,1956,1858,1834,7537
"2011-07-15_R17_Adelaide-v-Essendon",1687,1819,1952,1841,7299
"2011-07-16_R17_Carlton-v-Collingwood",1739,1790,2069,1647,7245
"2011-07-16_R17_Melbourne-v-Port Adelaide",1833,1897,1923,1811,7464
"2011-07-16_R17_St Kilda-v-West Coast",1658,1721,1871,1753,7003
"2011-07-17_R17_Brisbane Lions-v-Geelong",1760,1901,2184,1911,7756
"2011-07-17_R17_North Melbourne-v-Western Bulldogs",1905,1940,1851,2072,7768
"2011-07-17_R17_Sydney-v-Fremantle",1886,1865,2044,2011,7806
"2011-07-23_R18_Essendon-v-Carlton",1882,1904,1765,1927,7478
"2011-07-23_R18_Gold Coast-v-Collingwood",1890,1976,1683,1719,7268
"2011-07-23_R18_North Melbourne-v-Brisbane Lions",1884,2050,1842,1786,7562
"2011-07-23_R18_Sydney-v-Western Bulldogs",1789,2199,1879,2017,7884
"2011-07-24_R18_Fremantle-v-West Coast",1735,1683,1886,1864,7168
"2011-07-24_R18_Geelong-v-Richmond",1684,1676,1777,1717,6854
"2011-07-24_R18_Melbourne-v-Hawthorn",1959,1823,1887,1771,7440
"2011-07-29_R19_North Melbourne-v-Carlton",1833,1636,1727,1759,6955
"2011-07-30_R19_Fremantle-v-Hawthorn",1765,1961,1931,1853,7510
"2011-07-30_R19_Gold Coast-v-St Kilda",1763,1774,1646,1629,6812
"2011-07-30_R19_Western Bulldogs-v-West Coast",1913,1807,1890,1893,7503
"2011-07-31_R19_Adelaide-v-Port Adelaide",1798,1843,2013,1647,7301
"2011-07-31_R19_Collingwood-v-Essendon",2187,1947,1908,1935,7977
"2011-08-05_R20_St Kilda-v-Fremantle",1885,1998,1872,1911,7666
"2011-08-06_R20_Carlton-v-Melbourne",2152,1909,1799,1859,7719
"2011-08-06_R20_Essendon-v-Sydney",1699,2101,1973,1690,7463
"2011-08-07_R20_Brisbane Lions-v-Adelaide",2020,1920,1722,1987,7649
"2011-08-07_R20_Hawthorn-v-North Melbourne",1912,2034,1870,2102,7918
"2011-08-07_R20_West Coast-v-Richmond",1834,1858,2152,1821,7665
"2011-08-12_R21_St Kilda-v-Collingwood",1841,1890,1730,1855,7316
"2011-08-13_R21_Brisbane Lions-v-Gold Coast",1907,1780,1665,2060,7412
"2011-08-13_R21_Fremantle-v-Carlton",1838,1766,1811,1958,7373
"2011-08-13_R21_Western Bulldogs-v-Essendon",1752,1920,1947,2121,7740
"2011-08-14_R21_Adelaide-v-Geelong",1649,1847,1782,1818,7096
"2011-08-14_R21_Melbourne-v-West Coast",1649,1944,1741,1779,7113
"2011-08-14_R21_Richmond-v-Sydney",1652,1797,1689,1872,7010
"2011-08-19_R22_Carlton-v-Hawthorn",1814,1768,1779,1852,7213
"2011-08-20_R22_Collingwood-v-Brisbane Lions",1752,1792,1838,1800,7182
"2011-08-20_R22_Gold Coast-v-Adelaide",1950,1753,1719,1893,7315
"2011-08-20_R22_North Melbourne-v-Fremantle",1905,1705,1915,1783,7308
"2011-08-20_R22_West Coast-v-Essendon",1931,1973,2061,2023,7988
"2011-08-21_R22_Melbourne-v-Richmond",2065,1764,1758,1979,7566
"2011-08-21_R22_Port Adelaide-v-Western Bulldogs",2061,1874,2166,1867,7968
"2011-08-21_R22_Sydney-v-St Kilda",1893,1866,1966,1911,7636
"2011-08-26_R23_Fremantle-v-Collingwood",2030,1800,2161,1865,7856
"2011-08-27_R23_Brisbane Lions-v-West Coast",1963,1687,1912,1962,7524
"2011-08-27_R23_Geelong-v-Sydney",1855,1893,1879,2060,7687
"2011-08-27_R23_Hawthorn-v-Western Bulldogs",1713,1715,1657,1869,6954
"2011-08-27_R23_St Kilda-v-North Melbourne",1902,2067,1869,1601,7439
"2011-08-28_R23_Adelaide-v-Richmond",2096,1616,2025,1923,7660
"2011-08-28_R23_Essendon-v-Port Adelaide",1977,1918,1820,1999,7714
"2011-08-28_R23_Melbourne-v-Gold Coast",1709,1927,1857,1818,7311
"2011-09-02_R24_Collingwood-v-Geelong",1879,2022,1906,1760,7567
"2011-09-03_R24_Carlton-v-St Kilda",1609,1672,1821,1880,6982
"2011-09-03_R24_Gold Coast-v-Hawthorn",1859,1829,1924,2119,7731
"2011-09-03_R24_Sydney-v-Brisbane Lions",1880,2095,1768,1810,7553
"2011-09-03_R24_West Coast-v-Adelaide",1678,2043,1942,2067,7730
"2011-09-03_R24_Western Bulldogs-v-Fremantle",1658,1765,1661,1912,6996
"2011-09-04_R24_Port Adelaide-v-Melbourne",1855,1964,1968,2062,7849
"2011-09-04_R24_Richmond-v-North Melbourne",1848,1790,1905,1820,7363
"2011-09-09_RQualifying_Geelong-v-Hawthorn",1716,2113,1921,1747,7497
"2011-09-10_RElimination_Sydney-v-St Kilda",1588,1930,1722,1676,6916
"2011-09-10_RQualifying_Collingwood-v-West Coast",1751,1884,1766,1894,7295
"2011-09-11_RElimination_Carlton-v-Essendon",1896,1846,2080,1938,7760
"2011-09-16_RSemi_Hawthorn-v-Sydney",1706,2024,2027,2098,7855
"2011-09-17_RSemi_West Coast-v-Carlton",1756,2153,1840,2173,7922
"2011-09-23_RPreliminary_Collingwood-v-Hawthorn",1731,1585,1743,1789,6848
"2011-09-24_RPreliminary_Geelong-v-West Coast",1955,1826,1983,1725,7489
"2011-10-01_RGrand_Geelong-v-Collingwood",1935,2167,2048,1838,7988
"2012-03-24_R1_Greater Western Sydney-v-Sydney",1648,1907,1740,1798,7093
"2012-03-29_R1_Richmond-v-Carlton",1861,1796,1812,1763,7232
"2012-03-30_R1_Hawthorn-v-Collingwood",1684,2087,1826,2025,7622
"2012-03-31_R1_Fremantle-v-Geelong",1939,1948,1849,1836,7572
"2012-03-31_R1_Gold Coast-v-Adelaide",1946,2123,1827,1852,7748
"2012-03-31_R1_Melbourne-v-Brisbane Lions",1770,1941,1952,1892,7555
"2012-03-31_R1_North Melbourne-v-Essendon",1702,2093,1839,1868,7502
"2012-04-01_R1_Port Adelaide-v-St Kilda",1799,2052,1904,1861,7616
"2012-04-01_R1_Western Bulldogs-v-West Coast",1930,1858,1899,1833,7520
"2012-04-05_R2_Brisbane Lions-v-Carlton",2078,1891,1664,1933,7566
"2012-04-07_R2_Adelaide-v-Western Bulldogs",1723,1752,1690,1805,6970
"2012-04-07_R2_Collingwood-v-Richmond",1640,1647,1847,1637,6771
"2012-04-07_R2_Essendon-v-Port Adelaide",1991,1817,1775,1740,7323
"2012-04-07_R2_Sydney-v-Fremantle",1769,1781,1951,1970,7471
"2012-04-07_R2_West Coast-v-Melbourne",1764,1930,2010,1801,7505
"2012-04-08_R2_St Kilda-v-Gold Coast",1711,1937,2003,1764,7415
"2012-04-09_R2_Geelong-v-Hawthorn",1854,1806,1827,1896,7383
"2012-04-13_R3_Carlton-v-Collingwood",2008,1664,1883,1641,7196
"2012-04-14_R3_Fremantle-v-Brisbane Lions",1622,1760,1761,1797,6940
"2012-04-14_R3_Gold Coast-v-Essendon",1907,1764,1919,1799,7389
"2012-04-14_R3_Port Adelaide-v-Sydney",1865,1744,1897,1895,7401
"2012-04-14_R3_Richmond-v-Melbourne",1893,1709,1962,1917,7481
"2012-04-14_R3_Western Bulldogs-v-St Kilda",1806,1667,1832,1760,7065
"2012-04-15_R3_Hawthorn-v-Adelaide",1827,1731,1800,2095,7453
"2012-04-15_R3_North Melbourne-v-Geelong",1725,1873,1897,2045,7540
"2012-04-20_R4_St Kilda-v-Fremantle",1930,1768,1833,1867,7398
"2012-04-21_R4_Brisbane Lions-v-Gold Coast",1727,1869,1739,1844,7179
"2012-04-21_R4_Carlton-v-Essendon",1893,1666,1764,2088,7411
"2012-04-21_R4_Collingwood-v-Port Adelaide",1932,1741,1791,1880,7344
"2012-04-21_R4_West Coast-v-Hawthorn",1576,1607,1803,1996,6982
"2012-04-22_R4_Geelong-v-Richmond",1851,1784,1819,1732,7186
"2012-04-22_R4_Melbourne-v-Western Bulldogs",1754,1756,2091,1829,7430
"2012-04-22_R4_Sydney-v-North Melbourne",1961,2054,1874,1916,7805
"2012-04-25_R5_Collingwood-v-Essendon",1693,1757,1972,1889,7311
"2012-04-27_R5_Fremantle-v-Carlton",1704,1888,1710,1617,6919
"2012-04-28_R5_Brisbane Lions-v-Geelong",1675,1815,1812,1981,7283
"2012-04-28_R5_Greater Western Sydney-v-Western Bulldogs",1743,2084,1885,1768,7480
"2012-04-28_R5_Melbourne-v-St Kilda",1957,2038,1898,1658,7551
"2012-04-28_R5_North Melbourne-v-Gold Coast",2040,2086,1948,1894,7968
"2012-04-29_R5_Adelaide-v-Port Adelaide",1809,1839,1848,1786,7282
"2012-04-29_R5_Hawthorn-v-Sydney",1813,1797,1791,1920,7321
"2012-04-29_R5_Richmond-v-West Coast",1784,1874,1676,1889,7223
"2012-05-04_R6_Western Bulldogs-v-Collingwood",1745,1820,1935,1732,7232
"2012-05-05_R6_Essendon-v-Brisbane Lions",2149,1780,1796,1667,7392
"2012-05-05_R6_Geelong-v-Melbourne",1758,1854,2000,1548,7160
"2012-05-05_R6_Gold Coast-v-Fremantle",2026,1707,1938,2027,7698
"2012-05-05_R6_St Kilda-v-Hawthorn",1797,1861,1989,1664,7311
"2012-05-05_R6_Sydney-v-Adelaide",1855,1951,1818,1859,7483
"2012-05-06_R6_Carlton-v-Greater Western Sydney",1757,1815,1685,1661,6918
"2012-05-06_R6_Port Adelaide-v-Richmond",1663,1708,1772,1865,7008
"2012-05-06_R6_West Coast-v-North Melbourne",1837,1906,1944,1819,7506
"2012-05-11_R7_Melbourne-v-Hawthorn",1724,1896,1565,1715,6900
"2012-05-12_R7_Adelaide-v-Geelong",1797,2031,1779,1813,7420
"2012-05-12_R7_Brisbane Lions-v-Collingwood",1933,1671,1848,1766,7218
"2012-05-12_R7_Essendon-v-West Coast",1546,1809,1781,1793,6929
"2012-05-12_R7_Richmond-v-Sydney",1817,1678,1605,1767,6867
"2012-05-13_R7_Fremantle-v-Port Adelaide",1951,1813,1728,1802,7294
"2012-05-13_R7_North Melbourne-v-Western Bulldogs",1961,1990,1911,1582,7444
"2012-05-14_R7_St Kilda-v-Carlton",1997,1952,1931,1753,7633
"2012-05-18_R8_Collingwood-v-Geelong",1799,1824,1826,1854,7303
"2012-05-19_R8_Essendon-v-Richmond",1826,1782,1899,1788,7295
"2012-05-19_R8_Hawthorn-v-Fremantle",1640,1984,1807,1709,7140
"2012-05-19_R8_Port Adelaide-v-North Melbourne",1919,1736,1990,1916,7561
"2012-05-19_R8_Sydney-v-Melbourne",1890,1837,1821,1727,7275
"2012-05-20_R8_Brisbane Lions-v-Greater Western Sydney",1838,1768,1667,1772,7045
"2012-05-20_R8_Carlton-v-Adelaide",1880,1962,1895,1712,7449
"2012-05-20_R8_West Coast-v-St Kilda",1720,2026,2008,1737,7491
"2012-05-25_R9_Western Bulldogs-v-Geelong",1709,1786,1570,1960,7025
"2012-05-26_R9_Adelaide-v-Collingwood",1855,1712,1786,2113,7466
"2012-05-26_R9_Gold Coast-v-Port Adelaide",1815,1827,1871,1825,7338
"2012-05-26_R9_Greater Western Sydney-v-Essendon",1697,1845,1857,1883,7282
"2012-05-26_R9_Richmond-v-Hawthorn",1726,1992,1841,1874,7433
"2012-05-26_R9_St Kilda-v-Sydney",1780,1823,1976,1799,7378
"2012-05-27_R9_Carlton-v-Melbourne",1825,1871,1751,1826,7273
"2012-05-27_R9_North Melbourne-v-Brisbane Lions",1874,1891,1838,1801,7404
"2012-05-27_R9_West Coast-v-Fremantle",1605,1632,1859,1808,6904
"2012-06-01_R10_St Kilda-v-Richmond",1777,1933,1717,1937,7364
"2012-06-02_R10_Essendon-v-Melbourne",1607,1705,1755,1728,6795
"2012-06-02_R10_Fremantle-v-Adelaide",1843,1853,1713,1838,7247
"2012-06-02_R10_Geelong-v-Greater Western Sydney",1864,1835,1884,1667,7250
"2012-06-02_R10_Hawthorn-v-North Melbourne",1875,1892,1960,1876,7603
"2012-06-02_R10_Port Adelaide-v-Carlton",1900,1843,1700,1917,7360
"2012-06-03_R10_Brisbane Lions-v-West Coast",1746,1752,1770,2278,7546
"2012-06-03_R10_Collingwood-v-Gold Coast",1841,1927,1718,1777,7263
"2012-06-03_R10_Sydney-v-Western Bulldogs",2202,1763,1914,1795,7674
"2012-06-08_R11_Carlton-v-Geelong",1876,1794,1948,1773,7391
"2012-06-09_R11_Essendon-v-Sydney",1667,1607,1769,2098,7141
"2012-06-09_R11_Gold Coast-v-St Kilda",1633,1803,2110,1830,7376
"2012-06-09_R11_Richmond-v-Fremantle",1852,1705,1820,1782,7159
"2012-06-10_R11_Port Adelaide-v-Hawthorn",1987,1639,1767,1968,7361
"2012-06-11_R11_Melbourne-v-Collingwood",1857,1729,1788,2035,7409
"2012-06-14_R12_West Coast-v-Carlton",1858,1853,1799,1957,7467
"2012-06-15_R12_Adelaide-v-St Kilda",1903,2073,1894,1770,7640
"2012-06-16_R12_Gold Coast-v-North Melbourne",1689,1841,1985,1982,7497
"2012-06-16_R12_Greater Western Sydney-v-Richmond",1972,1867,1858,1719,7416
"2012-06-17_R12_Hawthorn-v-Brisbane Lions",2045,1745,1836,1909,7535
"2012-06-17_R12_Western Bulldogs-v-Port Adelaide",1624,1706,1820,1618,6768
"2012-06-22_R13_Sydney-v-Geelong",1865,1572,1720,1899,7056
"2012-06-23_R13_Collingwood-v-West Coast",1697,1815,1811,1630,6953
"2012-06-23_R13_Fremantle-v-Essendon",1913,1766,1871,1692,7242
"2012-06-23_R13_Western Bulldogs-v-Brisbane Lions",1877,1684,1770,1845,7176
"2012-06-24_R13_Melbourne-v-Greater Western Sydney",1978,1859,1799,1612,7248
"2012-06-24_R13_North Melbourne-v-Adelaide",1907,1600,1962,1807,7276
"2012-06-29_R14_Carlton-v-Hawthorn",1995,1889,1789,1662,7335
"2012-06-30_R14_Adelaide-v-Richmond",1943,1774,1741,1883,7341
"2012-06-30_R14_Collingwood-v-Fremantle",1746,1763,1784,1935,7228
"2012-06-30_R14_Essendon-v-Western Bulldogs",1768,1851,1752,1844,7215
"2012-06-30_R14_Sydney-v-Greater Western Sydney",1852,1801,1981,1825,7459
"2012-06-30_R14_West Coast-v-Gold Coast",1950,1788,1949,1816,7503
"2012-07-01_R14_Brisbane Lions-v-Melbourne",1901,1705,1645,1808,7059
"2012-07-01_R14_Geelong-v-Port Adelaide",1816,1673,1855,1812,7156
"2012-07-01_R14_St Kilda-v-North Melbourne",1866,1914,1793,1939,7512
"2012-07-06_R15_Collingwood-v-Carlton",1668,1802,1701,1774,6945
"2012-07-07_R15_Melbourne-v-Richmond",1807,1854,1710,2026,7397
"2012-07-07_R15_North Melbourne-v-West Coast",1841,1675,1803,1762,7081
"2012-07-07_R15_Port Adelaide-v-Adelaide",1882,1855,1951,1863,7551
"2012-07-07_R15_St Kilda-v-Essendon",1760,1799,2065,1807,7431
"2012-07-07_R15_Sydney-v-Brisbane Lions",1801,2052,1745,1647,7245
"2012-07-08_R15_Fremantle-v-Western Bulldogs",1592,1882,2022,1730,7226
"2012-07-08_R15_Gold Coast-v-Geelong",1732,1621,2009,1764,7126
"2012-07-13_R16_North Melbourne-v-Carlton",1831,1970,1871,1965,7637
"2012-07-14_R16_Brisbane Lions-v-St Kilda",1916,1854,1829,2002,7601
"2012-07-14_R16_Geelong-v-Collingwood",1904,1733,1795,1737,7169
"2012-07-14_R16_Melbourne-v-Fremantle",1887,1758,1877,1870,7392
"2012-07-14_R16_Port Adelaide-v-Essendon",1918,1750,1868,1822,7358
"2012-07-14_R16_Richmond-v-Gold Coast",1757,1705,1834,1780,7076
"2012-07-15_R16_Greater Western Sydney-v-Adelaide",1971,1883,1845,1971,7670
"2012-07-15_R16_West Coast-v-Sydney",1941,1963,1893,1852,7649
"2012-07-15_R16_Western Bulldogs-v-Hawthorn",1764,1822,1771,1579,6936
"2012-07-20_R17_Geelong-v-Essendon",1710,1995,1881,1747,7333
"2012-07-21_R17_Adelaide-v-West Coast",1858,1840,1836,1784,7318
"2012-07-21_R17_Collingwood-v-Hawthorn",1947,1796,1851,1832,7426
"2012-07-21_R17_Melbourne-v-Port Adelaide",1887,1767,1828,1711,7193
"2012-07-21_R17_Western Bulldogs-v-Carlton",1724,1753,1811,1912,7200
"2012-07-22_R17_Fremantle-v-Greater Western Sydney",1828,1697,1995,1691,7211
"2012-07-22_R17_Richmond-v-North Melbourne",1842,1892,1764,2028,7526
"2012-07-22_R17_Sydney-v-St Kilda",1785,1695,1979,2059,7518
"2012-07-27_R18_Essendon-v-Hawthorn",1962,2009,2067,1853,7891
"2012-07-28_R18_Carlton-v-Richmond",2077,1724,1928,2158,7887
"2012-07-28_R18_Geelong-v-Adelaide",1807,1829,1673,1881,7190
"2012-07-28_R18_Gold Coast-v-Sydney",1840,1727,1930,1627,7124
"2012-07-28_R18_Greater Western Sydney-v-Collingwood",2032,1862,1606,1868,7368
"2012-07-28_R18_North Melbourne-v-Melbourne",1692,1887,1889,1878,7346
"2012-07-29_R18_Port Adelaide-v-Fremantle",1824,1539,1691,1863,6917
"2012-07-29_R18_St Kilda-v-Western Bulldogs",1770,1790,1825,1613,6998
"2012-07-29_R18_West Coast-v-Brisbane Lions",1988,1859,1839,2217,7903
"2012-08-03_R19_Hawthorn-v-Geelong",1902,1875,1809,1994,7580
"2012-08-04_R19_Brisbane Lions-v-Richmond",1718,1854,1818,2068,7458
"2012-08-04_R19_Collingwood-v-St Kilda",1785,1713,1840,1813,7151
"2012-08-04_R19_Fremantle-v-West Coast",1830,1861,2065,1750,7506
"2012-08-04_R19_Western Bulldogs-v-North Melbourne",1894,1781,1770,1872,7317
"2012-08-05_R19_Adelaide-v-Essendon",1984,1773,1857,1862,7476
"2012-08-05_R19_Carlton-v-Sydney",1813,1683,1836,1845,7177
"2012-08-05_R19_Melbourne-v-Gold Coast",1709,1849,1597,1730,6885
"2012-08-10_R20_West Coast-v-Geelong",2277,1963,1892,2065,8197
"2012-08-11_R20_Adelaide-v-Fremantle",1838,1779,1964,1927,7508
"2012-08-11_R20_Carlton-v-Brisbane Lions",1680,1695,1857,1850,7082
"2012-08-11_R20_St Kilda-v-Melbourne",1660,1718,1947,2026,7351
"2012-08-11_R20_Sydney-v-Collingwood",1844,1756,2104,1829,7533
"2012-08-12_R20_Essendon-v-North Melbourne",2116,1707,1647,1772,7242
"2012-08-12_R20_Hawthorn-v-Port Adelaide",1716,1983,1866,2062,7627
"2012-08-12_R20_Richmond-v-Western Bulldogs",1842,1760,1991,1626,7219
"2012-08-17_R21_Geelong-v-St Kilda",1831,1900,1803,1936,7470
"2012-08-18_R21_Brisbane Lions-v-Adelaide",1722,1720,1985,1681,7108
"2012-08-18_R21_Collingwood-v-North Melbourne",1797,1788,1734,1550,6869
"2012-08-18_R21_Essendon-v-Carlton",1782,2109,1777,1630,7298
"2012-08-18_R21_Fremantle-v-Richmond",1728,2029,1772,1796,7325
"2012-08-18_R21_Greater Western Sydney-v-Melbourne",1897,1855,1752,1987,7491
"2012-08-19_R21_Hawthorn-v-Gold Coast",1882,1642,1872,1894,7290
"2012-08-19_R21_Port Adelaide-v-West Coast",1712,1810,1731,1800,7053
"2012-08-19_R21_Western Bulldogs-v-Sydney",1857,1916,1817,2075,7665
"2012-08-24_R22_Richmond-v-Essendon",1748,1702,1769,1549,6768
"2012-08-25_R22_Gold Coast-v-Carlton",1938,1897,1751,1709,7295
"2012-08-25_R22_Port Adelaide-v-Brisbane Lions",1910,1918,1963,1789,7580
"2012-08-25_R22_St Kilda-v-Greater Western Sydney",1848,1964,1569,1893,7274
"2012-08-25_R22_Sydney-v-Hawthorn",1883,2001,1845,1910,7639
"2012-08-25_R22_West Coast-v-Collingwood",1753,1766,1802,1778,7099
"2012-08-26_R22_Geelong-v-Western Bulldogs",1508,1763,1799,1877,6947
"2012-08-26_R22_Melbourne-v-Adelaide",1783,1854,2092,1799,7528
"2012-08-26_R22_North Melbourne-v-Fremantle",1772,1806,1945,2030,7553
"2012-08-31_R23_Hawthorn-v-West Coast",1860,1841,1831,1847,7379
"2012-09-01_R23_Adelaide-v-Gold Coast",1757,2025,1788,1800,7370
"2012-09-01_R23_Essendon-v-Collingwood",1786,1696,1771,1659,6912
"2012-09-01_R23_Fremantle-v-Melbourne",1747,1931,1844,1640,7162
"2012-09-01_R23_Geelong-v-Sydney",1843,1700,1771,1881,7195
"2012-09-01_R23_Greater Western Sydney-v-North Melbourne",1819,1664,1921,1877,7281
"2012-09-02_R23_Brisbane Lions-v-Western Bulldogs",1571,1833,1763,2010,7177
"2012-09-02_R23_Carlton-v-St Kilda",1744,1845,1852,2056,7497
"2012-09-02_R23_Richmond-v-Port Adelaide",1697,1717,2002,1887,7303
"2012-09-07_RQualifying_Hawthorn-v-Collingwood",1916,2027,2071,1708,7722
"2012-09-08_RElimination_Fremantle-v-Geelong",1694,1759,1801,1756,7010
"2012-09-08_RQualifying_Sydney-v-Adelaide",1706,1821,1553,1784,6864
"2012-09-09_RElimination_West Coast-v-North Melbourne",1799,1882,1978,1944,7603
"2012-09-14_RSemi_Adelaide-v-Fremantle",1606,1705,1628,1713,6652
"2012-09-15_RSemi_Collingwood-v-West Coast",1935,1593,1799,1738,7065
"2012-09-21_RPreliminary_Sydney-v-Collingwood",1873,1624,1759,1835,7091
"2012-09-22_RPreliminary_Hawthorn-v-Adelaide",1829,1835,1791,1765,7220
"2012-09-29_RGrand_Sydney-v-Hawthorn",1807,1759,1924,2011,7501
"2013-03-22_R1_Adelaide-v-Essendon",1738,1851,1870,1790,7249
"2013-03-23_R1_Fremantle-v-West Coast",1731,1816,2043,1856,7446
"2013-03-28_R1_Carlton-v-Richmond",1770,1935,1934,1828,7467
"2013-03-30_R1_Gold Coast-v-St Kilda",1696,1620,1708,1944,6968
"2013-03-30_R1_Greater Western Sydney-v-Sydney",1955,1904,1835,1773,7467
"2013-03-30_R1_Western Bulldogs-v-Brisbane Lions",1776,1828,1935,1760,7299
"2013-03-31_R1_Melbourne-v-Port Adelaide",1753,1966,1788,1659,7166
"2013-03-31_R1_North Melbourne-v-Collingwood",1798,1876,1939,1783,7396
"2013-04-01_R1_Hawthorn-v-Geelong",1730,1843,1739,1604,6916
"2013-04-05_R2_St Kilda-v-Richmond",1754,1778,1829,1658,7019
"2013-04-06_R2_Brisbane Lions-v-Adelaide",1671,1836,1966,1774,7247
"2013-04-06_R2_Essendon-v-Melbourne",1727,1858,1804,1738,7127
"2013-04-06_R2_Port Adelaide-v-Greater Western Sydney",1842,1887,1819,2001,7549
"2013-04-06_R2_Sydney-v-Gold Coast",1905,1906,1953,1871,7635
"2013-04-06_R2_Western Bulldogs-v-Fremantle",1815,1750,1991,1826,7382
"2013-04-07_R2_Collingwood-v-Carlton",1737,1743,1905,1889,7274
"2013-04-07_R2_Geelong-v-North Melbourne",1862,1859,1831,1805,7357
"2013-04-07_R2_West Coast-v-Hawthorn",1834,1983,1971,2045,7833
"2013-04-12_R3_Fremantle-v-Essendon",1957,1739,1911,1877,7484
"2013-04-13_R3_Geelong-v-Carlton",1814,1951,1673,1689,7127
"2013-04-13_R3_Gold Coast-v-Brisbane Lions",1898,1655,1895,1981,7429
"2013-04-13_R3_Greater Western Sydney-v-St Kilda",1729,1992,1907,1949,7577
"2013-04-13_R3_Melbourne-v-West Coast",1811,1873,1904,1878,7466
"2013-04-13_R3_North Melbourne-v-Sydney",1901,1734,2042,1873,7550
"2013-04-14_R3_Collingwood-v-Hawthorn",1810,1828,1993,1940,7571
"2013-04-14_R3_Port Adelaide-v-Adelaide",1983,1891,2050,1896,7820
"2013-04-14_R3_Richmond-v-Western Bulldogs",1666,1698,1837,1948,7149
"2013-04-19_R4_Sydney-v-Geelong",2170,1609,1875,1758,7412
"2013-04-20_R4_Gold Coast-v-Port Adelaide",1740,1806,1618,1660,6824
"2013-04-20_R4_Hawthorn-v-Fremantle",1739,1942,1800,1822,7303
"2013-04-20_R4_Richmond-v-Collingwood",1680,1728,1902,1862,7172
"2013-04-20_R4_St Kilda-v-Essendon",1912,1717,1876,1806,7311
"2013-04-20_R4_West Coast-v-Carlton",1706,1807,1762,1688,6963
"2013-04-21_R4_Adelaide-v-Western Bulldogs",1739,1848,1713,1861,7161
"2013-04-21_R4_Melbourne-v-Greater Western Sydney",1859,1926,1941,2146,7872
"2013-04-21_R4_North Melbourne-v-Brisbane Lions",1942,1717,1875,1715,7249
"2013-04-25_R5_Essendon-v-Collingwood",1526,1725,1921,2072,7244
"2013-04-25_R5_St Kilda-v-Sydney",1937,1775,1664,1780,7156
"2013-04-26_R5_Fremantle-v-Richmond",1813,1814,1641,1813,7081
"2013-04-27_R5_Carlton-v-Adelaide",1656,1623,1850,1785,6914
"2013-04-27_R5_Port Adelaide-v-West Coast",2037,1799,1784,1785,7405
"2013-04-27_R5_Western Bulldogs-v-Geelong",1763,1759,1843,1559,6924
"2013-04-28_R5_Brisbane Lions-v-Melbourne",2057,1645,1834,1841,7377
"2013-04-28_R5_Hawthorn-v-North Melbourne",1849,2011,1703,1839,7402
"2013-05-03_R6_Collingwood-v-St Kilda",1875,1552,1840,1764,7031
"2013-05-04_R6_Adelaide-v-Hawthorn",1803,1685,1720,1787,6995
"2013-05-04_R6_Essendon-v-Greater Western Sydney",1743,1630,1890,1917,7180
"2013-05-04_R6_Gold Coast-v-Fremantle",1700,1798,1740,1728,6966
"2013-05-04_R6_North Melbourne-v-Port Adelaide",1836,1849,1701,1819,7205
"2013-05-04_R6_Richmond-v-Geelong",1670,1897,2012,1768,7347
"2013-05-05_R6_Carlton-v-Melbourne",1714,1804,1845,1908,7271
"2013-05-05_R6_Sydney-v-Brisbane Lions",1817,1725,1876,1843,7261
"2013-05-05_R6_West Coast-v-Western Bulldogs",1839,1842,1948,1808,7437
"2013-05-10_R7_Geelong-v-Essendon",1753,1746,1901,1726,7126
"2013-05-11_R7_Brisbane Lions-v-West Coast",1899,1976,1847,1877,7599
"2013-05-11_R7_Fremantle-v-Collingwood",1766,1635,1777,1770,6948
"2013-05-11_R7_Hawthorn-v-Sydney",1753,1859,1797,1940,7349
"2013-05-11_R7_Port Adelaide-v-Richmond",1892,1951,1691,1648,7182
"2013-05-11_R7_Western Bulldogs-v-North Melbourne",1886,1807,1821,2031,7545
"2013-05-12_R7_Greater Western Sydney-v-Adelaide",1597,1914,2095,1693,7299
"2013-05-13_R7_St Kilda-v-Carlton",1773,1648,1578,1785,6784
"2013-05-17_R8_West Coast-v-North Melbourne",1792,1584,1820,1805,7001
"2013-05-18_R8_Collingwood-v-Geelong",1751,1672,1837,1615,6875
"2013-05-18_R8_Essendon-v-Brisbane Lions",1866,1884,1876,1800,7426
"2013-05-18_R8_Gold Coast-v-Western Bulldogs",1547,1675,1923,1589,6734
"2013-05-18_R8_Hawthorn-v-Greater Western Sydney",1897,1919,1809,1791,7416
"2013-05-18_R8_Sydney-v-Fremantle",1749,1603,1691,1773,6816
"2013-05-19_R8_Adelaide-v-St Kilda",1622,1539,1706,1524,6391
"2013-05-19_R8_Carlton-v-Port Adelaide",1852,1849,1827,1860,7388
"2013-05-19_R8_Richmond-v-Melbourne",1795,1931,1832,1702,7260
"2013-05-24_R9_Collingwood-v-Sydney",1872,1599,1719,1792,6982
"2013-05-25_R9_Brisbane Lions-v-Carlton",1879,1803,1783,1687,7152
"2013-05-25_R9_Greater Western Sydney-v-West Coast",1953,1950,1900,1710,7513
"2013-05-25_R9_Port Adelaide-v-Geelong",1719,1764,1655,1803,6941
"2013-05-25_R9_Richmond-v-Essendon",1705,1805,1667,1600,6777
"2013-05-25_R9_St Kilda-v-Western Bulldogs",1852,1728,1936,1883,7399
"2013-05-26_R9_Fremantle-v-Melbourne",1868,1700,1782,1634,6984
"2013-05-26_R9_Hawthorn-v-Gold Coast",1720,1871,1805,1881,7277
"2013-05-26_R9_North Melbourne-v-Adelaide",1627,2040,1824,1810,7301
"2013-05-31_R10_Brisbane Lions-v-Collingwood",1811,1792,1762,1679,7044
"2013-06-01_R10_Adelaide-v-Fremantle",1791,1679,1789,2012,7271
"2013-06-01_R10_Carlton-v-Greater Western Sydney",1765,1887,1775,1797,7224
"2013-06-01_R10_Geelong-v-Gold Coast",1749,1748,1793,1880,7170
"2013-06-01_R10_Sydney-v-Essendon",1820,1897,2326,2015,8058
"2013-06-01_R10_Western Bulldogs-v-Port Adelaide",1705,1839,1717,1895,7156
"2013-06-02_R10_Melbourne-v-Hawthorn",1676,1916,1778,1907,7277
"2013-06-02_R10_North Melbourne-v-St Kilda",1998,1870,1905,1530,7303
"2013-06-03_R10_West Coast-v-Richmond",1800,1700,2020,1694,7214
"2013-06-07_R11_Essendon-v-Carlton",1590,1735,1622,1921,6868
"2013-06-08_R11_Adelaide-v-Sydney",1644,1763,1787,1576,6770
"2013-06-08_R11_Greater Western Sydney-v-Geelong",1803,2057,2000,1989,7849
"2013-06-09_R11_St Kilda-v-West Coast",1746,1685,1789,1799,7019
"2013-06-10_R11_Melbourne-v-Collingwood",1540,1698,1729,1646,6613
"2013-06-14_R12_Carlton-v-Hawthorn",1964,1799,1934,1751,7448
"2013-06-15_R12_Essendon-v-Gold Coast",1572,1771,1645,1722,6710
"2013-06-15_R12_Fremantle-v-Brisbane Lions",1686,1699,1574,1798,6757
"2013-06-15_R12_Richmond-v-Adelaide",1882,1843,1652,1897,7274
"2013-06-16_R12_Collingwood-v-Western Bulldogs",1687,1908,1586,1775,6956
"2013-06-16_R12_Greater Western Sydney-v-Port Adelaide",1813,1722,1894,1741,7170
"2013-06-21_R13_Hawthorn-v-West Coast",2023,1716,1848,1774,7361
"2013-06-22_R13_Port Adelaide-v-Sydney",1800,1835,1745,1808,7188
"2013-06-22_R13_St Kilda-v-Melbourne",1832,1704,1661,1649,6846
"2013-06-22_R13_Western Bulldogs-v-Richmond",1799,1751,1638,1765,6953
"2013-06-23_R13_Brisbane Lions-v-Geelong",1849,1706,1805,1926,7286
"2013-06-27_R14_West Coast-v-Essendon",1880,1666,1920,1815,7281
"2013-06-28_R14_Sydney-v-Carlton",1794,1822,1800,1922,7338
"2013-06-29_R14_Geelong-v-Fremantle",1598,1699,1647,1716,6660
"2013-06-29_R14_Gold Coast-v-Adelaide",1704,1810,1915,1714,7143
"2013-06-29_R14_Melbourne-v-Western Bulldogs",1734,1879,1796,2037,7446
"2013-06-29_R14_Port Adelaide-v-Collingwood",1705,1657,1584,1766,6712
"2013-06-30_R14_Hawthorn-v-Brisbane Lions",1755,1810,2060,1953,7578
"2013-06-30_R14_North Melbourne-v-Greater Western Sydney",1831,1733,1569,1614,6747
"2013-06-30_R14_Richmond-v-St Kilda",1682,1803,1853,1782,7120
"2013-07-05_R15_Carlton-v-Collingwood",1954,1763,1737,1647,7101
"2013-07-06_R15_Adelaide-v-West Coast",1848,1744,1848,1829,7269
"2013-07-06_R15_Brisbane Lions-v-Gold Coast",1769,1797,1945,1670,7181
"2013-07-06_R15_Geelong-v-Hawthorn",1782,1653,1567,2328,7330
"2013-07-06_R15_Greater Western Sydney-v-Western Bulldogs",1877,1755,2099,2028,7759
"2013-07-06_R15_North Melbourne-v-Richmond",1779,2051,1891,1800,7521
"2013-07-07_R15_Essendon-v-Port Adelaide",1785,1792,1900,1876,7353
"2013-07-07_R15_Fremantle-v-St Kilda",1630,1773,1783,1744,6930
"2013-07-07_R15_Melbourne-v-Sydney",1737,1795,1782,1788,7102
"2013-07-12_R16_Collingwood-v-Adelaide",1734,1805,1706,1689,6934
"2013-07-13_R16_Brisbane Lions-v-North Melbourne",1915,1817,1941,1904,7577
"2013-07-13_R16_Carlton-v-St Kilda",1656,1791,1838,1740,7025
"2013-07-13_R16_Geelong-v-Melbourne",1740,1742,1893,1823,7198
"2013-07-13_R16_Port Adelaide-v-Hawthorn",1909,1891,1855,1645,7300
"2013-07-13_R16_Richmond-v-Gold Coast",1770,1763,1907,1576,7016
"2013-07-14_R16_Sydney-v-Greater Western Sydney",1789,1821,1750,2041,7401
"2013-07-14_R16_West Coast-v-Fremantle",1903,1811,1974,1934,7622
"2013-07-14_R16_Western Bulldogs-v-Essendon",1947,1613,2022,1727,7309
"2013-07-19_R17_North Melbourne-v-Carlton",1981,1626,1959,1873,7439
"2013-07-20_R17_Gold Coast-v-Collingwood",1711,1872,1737,1671,6991
"2013-07-20_R17_Greater Western Sydney-v-Essendon",1944,1759,2060,1842,7605
"2013-07-20_R17_Hawthorn-v-Western Bulldogs",1805,1641,1719,1895,7060
"2013-07-20_R17_Melbourne-v-Brisbane Lions",1962,1786,1960,1690,7398
"2013-07-20_R17_St Kilda-v-Port Adelaide",1988,1685,1716,1980,7369
"2013-07-21_R17_Adelaide-v-Geelong",1804,1736,1757,1879,7176
"2013-07-21_R17_Richmond-v-Fremantle",1648,1500,1769,1710,6627
"2013-07-21_R17_West Coast-v-Sydney",1758,1784,1594,1860,6996
"2013-07-26_R18_Essendon-v-Hawthorn",1862,1673,1886,1847,7268
"2013-07-27_R18_Collingwood-v-Greater Western Sydney",1920,1641,1885,1881,7327
"2013-07-27_R18_Fremantle-v-Adelaide",1766,1588,1611,1852,6817
"2013-07-27_R18_Geelong-v-St Kilda",1731,2107,1617,1642,7097
"2013-07-27_R18_Gold Coast-v-Carlton",1861,1810,1632,1802,7105
"2013-07-27_R18_Melbourne-v-North Melbourne",1727,1784,1892,1805,7208
"2013-07-28_R18_Port Adelaide-v-Brisbane Lions",1697,1792,1898,1651,7038
"2013-07-28_R18_Sydney-v-Richmond",1924,1711,1772,1988,7395
"2013-07-28_R18_Western Bulldogs-v-West Coast",1815,1761,1896,1772,7244
"2013-08-02_R19_North Melbourne-v-Geelong",1719,1983,1697,1708,7107
"2013-08-03_R19_Brisbane Lions-v-St Kilda",1664,1824,1834,1663,6985
"2013-08-03_R19_Carlton-v-Fremantle",1815,1714,1918,1673,7120
"2013-08-03_R19_Hawthorn-v-Richmond",1859,1709,1806,1865,7239
"2013-08-03_R19_West Coast-v-Gold Coast",1756,1937,1922,2128,7743
"2013-08-04_R19_Adelaide-v-Port Adelaide",1682,1955,1923,1895,7455
"2013-08-04_R19_Collingwood-v-Essendon",1696,1646,1757,1785,6884
"2013-08-04_R19_Western Bulldogs-v-Sydney",1897,1790,2020,1817,7524
"2013-08-09_R20_St Kilda-v-Hawthorn",1630,1693,1636,1824,6783
"2013-08-10_R20_Carlton-v-Western Bulldogs",1738,2017,2023,1744,7522
"2013-08-10_R20_Geelong-v-Port Adelaide",1809,1800,1989,1662,7260
"2013-08-10_R20_Gold Coast-v-Melbourne",1831,1698,2003,1848,7380
"2013-08-10_R20_Richmond-v-Brisbane Lions",1742,1856,1604,1769,6971
"2013-08-10_R20_Sydney-v-Collingwood",1749,1709,2047,1640,7145
"2013-08-11_R20_Adelaide-v-North Melbourne",1643,1842,1805,1655,6945
"2013-08-11_R20_Essendon-v-West Coast",1894,1900,1879,1754,7427
"2013-08-16_R21_Hawthorn-v-Collingwood",1857,1961,1651,1719,7188
"2013-08-17_R21_Brisbane Lions-v-Greater Western Sydney",1785,1863,1644,1798,7090
"2013-08-17_R21_Essendon-v-North Melbourne",1585,1791,1838,1824,7038
"2013-08-17_R21_Port Adelaide-v-Gold Coast",2002,2112,1762,1902,7778
"2013-08-17_R21_Richmond-v-Carlton",1969,1761,1793,1875,7398
"2013-08-17_R21_West Coast-v-Geelong",1865,1817,1754,1502,6938
"2013-08-18_R21_Melbourne-v-Fremantle",1799,1836,1723,1618,6976
"2013-08-18_R21_Sydney-v-St Kilda",1716,1805,1924,1826,7271
"2013-08-18_R21_Western Bulldogs-v-Adelaide",1912,1849,1911,1914,7586
"2013-08-23_R22_Collingwood-v-West Coast",2014,1612,1639,1457,6722
"2013-08-24_R22_Adelaide-v-Melbourne",1647,1921,1905,1853,7326
"2013-08-24_R22_Carlton-v-Essendon",1806,1655,1805,1700,6966
"2013-08-24_R22_Fremantle-v-Port Adelaide",1785,1697,1918,1934,7334
"2013-08-24_R22_Geelong-v-Sydney",1803,1601,1613,1751,6768
"2013-08-24_R22_North Melbourne-v-Hawthorn",1772,1892,1799,1591,7054
"2013-08-25_R22_Brisbane Lions-v-Western Bulldogs",1921,1762,1947,2053,7683
"2013-08-25_R22_Greater Western Sydney-v-Richmond",1789,1937,1779,1676,7181
"2013-08-25_R22_St Kilda-v-Gold Coast",1724,1906,1713,1698,7041
"2013-08-30_R23_Sydney-v-Hawthorn",1682,1833,1968,1822,7305
"2013-08-31_R23_Essendon-v-Richmond",1616,1565,1848,1689,6718
"2013-08-31_R23_Geelong-v-Brisbane Lions",1950,1889,1823,1814,7476
"2013-08-31_R23_Port Adelaide-v-Carlton",1815,1782,1802,1933,7332
"2013-08-31_R23_St Kilda-v-Fremantle",1619,1884,1640,1723,6866
"2013-08-31_R23_West Coast-v-Adelaide",1732,1822,1815,1703,7072
"2013-09-01_R23_Collingwood-v-North Melbourne",1949,1661,1899,1680,7189
"2013-09-01_R23_Western Bulldogs-v-Melbourne",1904,1894,1714,1745,7257
"2013-09-06_RQualifying_Hawthorn-v-Sydney",1767,1651,1703,1740,6861
"2013-09-07_RElimination_Port Adelaide-v-Collingwood",1670,1754,1587,1859,6870
"2013-09-07_RQualifying_Fremantle-v-Geelong",1918,1830,1733,1537,7018
"2013-09-08_RElimination_Carlton-v-Richmond",1767,1945,1812,1840,7364
"2013-09-13_RSemi_Geelong-v-Port Adelaide",1707,1779,1780,1773,7039
"2013-09-14_RSemi_Sydney-v-Carlton",1634,1866,1691,2059,7250
"2013-09-20_RPreliminary_Hawthorn-v-Geelong",1880,1744,1888,1784,7296
"2013-09-21_RPreliminary_Fremantle-v-Sydney",1685,1744,1878,2008,7315
"2013-09-28_RGrand_Hawthorn-v-Fremantle",1688,1684,1894,1754,7020
"2014-03-14_R1_Collingwood-v-Fremantle",1675,1731,1749,1745,6900
"2014-03-15_R1_Gold Coast-v-Richmond",1889,1704,1530,1937,7060
"2014-03-15_R1_Greater Western Sydney-v-Sydney",1952,1877,1811,1849,7489
"2014-03-16_R1_Carlton-v-Port Adelaide",1849,1960,1851,1847,7507
"2014-03-20_R1_Geelong-v-Adelaide",1881,1903,1708,1778,7270
"2014-03-21_R1_North Melbourne-v-Essendon",1745,1744,1759,1659,6907
"2014-03-22_R1_Hawthorn-v-Brisbane Lions",1689,1802,1970,1927,7388
"2014-03-22_R1_St Kilda-v-Melbourne",1620,1556,1714,1635,6525
"2014-03-23_R1_West Coast-v-Western Bulldogs",1779,1886,1694,2075,7434
"2014-03-27_R2_Richmond-v-Carlton",1820,1783,1821,1849,7273
"2014-03-28_R2_Essendon-v-Hawthorn",1723,1820,1811,1855,7209
"2014-03-29_R2_Fremantle-v-Gold Coast",1836,1646,1846,1811,7139
"2014-03-29_R2_Port Adelaide-v-Adelaide",1731,1683,1850,1893,7157
"2014-03-29_R2_St Kilda-v-Greater Western Sydney",1819,1767,1711,1796,7093
"2014-03-29_R2_Sydney-v-Collingwood",1647,1934,1927,1713,7221
"2014-03-30_R2_Brisbane Lions-v-Geelong",1628,1951,1951,1738,7268
"2014-03-30_R2_Melbourne-v-West Coast",1807,1698,1840,1836,7181
"2014-03-30_R2_Western Bulldogs-v-North Melbourne",1611,1754,1811,1841,7017
"2014-04-04_R3_Hawthorn-v-Fremantle",1888,1764,1772,1970,7394
"2014-04-05_R3_Adelaide-v-Sydney",1778,1776,2064,1746,7364
"2014-04-05_R3_Collingwood-v-Geelong",1627,1818,1619,1680,6744
"2014-04-05_R3_Gold Coast-v-Brisbane Lions",1708,1837,1996,1900,7441
"2014-04-05_R3_West Coast-v-St Kilda",1877,1880,1715,1831,7303
"2014-04-05_R3_Western Bulldogs-v-Richmond",1924,1791,1919,1921,7555
"2014-04-06_R3_Essendon-v-Carlton",1699,1876,1922,1704,7201
"2014-04-06_R3_North Melbourne-v-Port Adelaide",1809,1932,1828,1765,7334
"2014-04-11_R4_Richmond-v-Collingwood",1727,1734,1705,1963,7129
"2014-04-12_R4_Carlton-v-Melbourne",1743,1732,1805,1710,6990
"2014-04-12_R4_Geelong-v-West Coast",1726,1736,1617,1569,6648
"2014-04-12_R4_Gold Coast-v-Hawthorn",1963,1804,1833,1805,7405
"2014-04-12_R4_Greater Western Sydney-v-Western Bulldogs",1847,1734,1874,1834,7289
"2014-04-12_R4_Port Adelaide-v-Brisbane Lions",1887,1785,1844,1761,7277
"2014-04-13_R4_Fremantle-v-Essendon",1619,1743,1889,1912,7163
"2014-04-13_R4_St Kilda-v-Adelaide",1671,1742,1868,1656,6937
"2014-04-13_R4_Sydney-v-North Melbourne",1714,1828,1691,1937,7170
"2014-04-17_R5_Brisbane Lions-v-Richmond",1760,1796,2039,2071,7666
"2014-04-19_R5_Collingwood-v-North Melbourne",1720,1774,1550,1617,6661
"2014-04-19_R5_Essendon-v-St Kilda",1770,1538,1775,1592,6675
"2014-04-19_R5_Sydney-v-Fremantle",1714,1647,2135,1825,7321
"2014-04-19_R5_West Coast-v-Port Adelaide",1828,1708,1575,1727,6838
"2014-04-20_R5_Adelaide-v-Greater Western Sydney",1709,1786,1774,1816,7085
"2014-04-20_R5_Melbourne-v-Gold Coast",1721,1745,1740,1885,7091
"2014-04-20_R5_Western Bulldogs-v-Carlton",1947,2090,1883,1754,7674
"2014-04-21_R5_Geelong-v-Hawthorn",1805,1874,1906,1849,7434
"2014-04-25_R6_Collingwood-v-Essendon",1807,1799,1854,1816,7276
"2014-04-25_R6_Fremantle-v-North Melbourne",1877,1831,1624,1749,7081
"2014-04-25_R6_St Kilda-v-Brisbane Lions",1921,1803,1809,1915,7448
"2014-04-26_R6_Carlton-v-West Coast",1864,1937,1707,1714,7222
"2014-04-26_R6_Gold Coast-v-Greater Western Sydney",1812,1864,1873,1993,7542
"2014-04-26_R6_Melbourne-v-Sydney",1776,1666,1681,1569,6692
"2014-04-27_R6_Port Adelaide-v-Geelong",1823,1646,1911,1667,7047
"2014-04-27_R6_Richmond-v-Hawthorn",1675,1688,1887,1930,7180
"2014-04-27_R6_Western Bulldogs-v-Adelaide",1728,1657,1596,1990,6971
"2014-05-02_R7_Carlton-v-Collingwood",1744,1645,1675,1937,7001
"2014-05-03_R7_Adelaide-v-Melbourne",1809,1673,1883,1958,7323
"2014-05-03_R7_Brisbane Lions-v-Sydney",1666,1701,1778,1663,6808
"2014-05-03_R7_Essendon-v-Western Bulldogs",1754,1611,1892,1609,6866
"2014-05-03_R7_Greater Western Sydney-v-Port Adelaide",1884,1896,1931,2139,7850
"2014-05-03_R7_Hawthorn-v-St Kilda",1774,1818,1966,1788,7346
"2014-05-04_R7_Geelong-v-Richmond",1622,1965,1796,2027,7410
"2014-05-04_R7_North Melbourne-v-Gold Coast",1850,1883,1716,1876,7325
"2014-05-04_R7_West Coast-v-Fremantle",1744,1685,1751,1525,6705
"2014-05-09_R8_Sydney-v-Hawthorn",1855,1769,1987,1925,7536
"2014-05-10_R8_Brisbane Lions-v-Essendon",1749,1744,1805,1555,6853
"2014-05-10_R8_Melbourne-v-Western Bulldogs",1791,1753,2073,2017,7634
"2014-05-10_R8_Port Adelaide-v-Fremantle",1766,1896,1797,1786,7245
"2014-05-11_R8_West Coast-v-Greater Western Sydney",1719,1923,1991,1970,7603
"2014-05-12_R8_St Kilda-v-Carlton",1767,1987,1743,1794,7291
"2014-05-15_R9_Adelaide-v-Collingwood",1777,1991,1737,1768,7273
"2014-05-16_R9_Essendon-v-Sydney",1849,1849,2021,1667,7386
"2014-05-17_R9_Fremantle-v-Geelong",1700,1843,1955,1729,7227
"2014-05-17_R9_North Melbourne-v-Brisbane Lions",1733,1722,1766,1716,6937
"2014-05-17_R9_Richmond-v-Melbourne",1709,1683,1873,1765,7030
"2014-05-18_R9_St Kilda-v-Gold Coast",1890,1839,1887,1707,7323
"2014-05-23_R10_Geelong-v-North Melbourne",1737,1794,1823,1738,7092
"2014-05-24_R10_Collingwood-v-West Coast",1814,1706,1799,1958,7277
"2014-05-24_R10_Greater Western Sydney-v-Richmond",1861,1825,1824,1822,7332
"2014-05-24_R10_Port Adelaide-v-Hawthorn",1730,1823,1883,1913,7349
"2014-05-25_R10_Carlton-v-Adelaide",1633,1810,1886,1852,7181
"2014-05-25_R10_Gold Coast-v-Western Bulldogs",1818,1881,1908,1820,7427
"2014-05-29_R11_Sydney-v-Geelong",1682,1691,1859,2123,7355
"2014-05-30_R11_St Kilda-v-Collingwood",1901,1816,1747,1778,7242
"2014-05-31_R11_Brisbane Lions-v-Carlton",1869,2045,1805,2008,7727
"2014-05-31_R11_Essendon-v-Richmond",1623,1820,1554,1722,6719
"2014-05-31_R11_Melbourne-v-Port Adelaide",1795,1780,1885,1795,7255
"2014-06-01_R11_Adelaide-v-Gold Coast",1905,1882,1841,1782,7410
"2014-06-01_R11_Hawthorn-v-Greater Western Sydney",2005,1888,2120,1856,7869
"2014-06-01_R11_West Coast-v-North Melbourne",1706,1769,1754,1634,6863
"2014-06-01_R11_Western Bulldogs-v-Fremantle",1690,1799,1744,1730,6963
"2014-06-06_R12_Geelong-v-Carlton",1741,1918,1697,1911,7267
"2014-06-07_R12_Greater Western Sydney-v-Essendon",1737,1864,1605,1763,6969
"2014-06-07_R12_Hawthorn-v-West Coast",1797,2029,1842,1886,7554
"2014-06-07_R12_Port Adelaide-v-St Kilda",1824,1780,1760,1863,7227
"2014-06-07_R12_Western Bulldogs-v-Brisbane Lions",1930,1979,1750,1637,7296
"2014-06-08_R12_Fremantle-v-Adelaide",1693,1577,1761,1735,6766
"2014-06-08_R12_Gold Coast-v-Sydney",1808,1853,1787,1840,7288
"2014-06-08_R12_North Melbourne-v-Richmond",1810,1887,1918,1801,7416
"2014-06-09_R12_Melbourne-v-Collingwood",1557,1520,1570,1566,6213
"2014-06-13_R13_Carlton-v-Hawthorn",1814,1785,2004,1814,7417
"2014-06-14_R13_Adelaide-v-North Melbourne",1696,1787,1884,1837,7204
"2014-06-14_R13_Richmond-v-Fremantle",1549,1809,1883,1759,7000
"2014-06-14_R13_Sydney-v-Port Adelaide",1820,1945,1907,1909,7581
"2014-06-14_R13_West Coast-v-Gold Coast",1824,1904,1824,1828,7380
"2014-06-15_R13_Collingwood-v-Western Bulldogs",1860,1987,1896,1700,7443
"2014-06-15_R13_Essendon-v-Melbourne",1581,1867,1771,1820,7039
"2014-06-15_R13_Geelong-v-St Kilda",1860,1780,1765,1721,7126
"2014-06-20_R14_Richmond-v-Sydney",1678,1697,1572,1725,6672
"2014-06-21_R14_Essendon-v-Adelaide",1837,1773,1725,1909,7244
"2014-06-21_R14_Gold Coast-v-Geelong",1820,1583,1822,1908,7133
"2014-06-21_R14_Hawthorn-v-Collingwood",1726,1682,1932,1812,7152
"2014-06-21_R14_Port Adelaide-v-Western Bulldogs",1715,1887,2083,1879,7564
"2014-06-22_R14_Greater Western Sydney-v-Carlton",1935,1835,1884,1825,7479
"2014-06-22_R14_Melbourne-v-North Melbourne",1725,1756,2026,1783,7290
"2014-06-22_R14_St Kilda-v-West Coast",1906,1745,1756,1656,7063
"2014-06-27_R15_Geelong-v-Essendon",1673,1699,1695,1914,6981
"2014-06-28_R15_Brisbane Lions-v-North Melbourne",1744,1894,1733,1992,7363
"2014-06-28_R15_Fremantle-v-West Coast",1842,1737,1900,1838,7317
"2014-06-28_R15_Hawthorn-v-Gold Coast",1915,1948,1856,1983,7702
"2014-06-28_R15_St Kilda-v-Richmond",1647,1857,1748,1839,7091
"2014-06-28_R15_Sydney-v-Greater Western Sydney",2114,1760,1840,1700,7414
"2014-06-29_R15_Adelaide-v-Port Adelaide",1917,1756,1949,1852,7474
"2014-06-29_R15_Collingwood-v-Carlton",1817,1674,1745,1899,7135
"2014-06-29_R15_Western Bulldogs-v-Melbourne",1755,1761,2028,1948,7492
"2014-07-04_R16_North Melbourne-v-Hawthorn",1820,1654,2066,1689,7229
"2014-07-05_R16_Gold Coast-v-Collingwood",1858,1773,1550,1894,7075
"2014-07-05_R16_Greater Western Sydney-v-Adelaide",1818,1848,1926,1948,7540
"2014-07-05_R16_Melbourne-v-Fremantle",1638,1781,2022,1650,7091
"2014-07-05_R16_Port Adelaide-v-Essendon",1854,1791,1801,1767,7213
"2014-07-05_R16_Richmond-v-Brisbane Lions",1804,1697,1823,1617,6941
"2014-07-06_R16_Carlton-v-St Kilda",1718,1740,1919,1778,7155
"2014-07-06_R16_Geelong-v-Western Bulldogs",1793,1838,1867,1639,7137
"2014-07-06_R16_West Coast-v-Sydney",1877,1775,1744,1697,7093
"2014-07-11_R17_Adelaide-v-Hawthorn",1758,1934,2016,1749,7457
"2014-07-12_R17_Brisbane Lions-v-West Coast",1639,1780,1944,1653,7016
"2014-07-12_R17_Melbourne-v-Geelong",1748,2031,1749,1751,7279
"2014-07-12_R17_North Melbourne-v-St Kilda",1723,1713,1808,1707,6951
"2014-07-12_R17_Sydney-v-Carlton",1859,1943,2126,1659,7587
"2014-07-12_R17_Western Bulldogs-v-Gold Coast",1937,1839,1759,1826,7361
"2014-07-13_R17_Essendon-v-Collingwood",1697,1634,1802,1537,6670
"2014-07-13_R17_Fremantle-v-Greater Western Sydney",1757,1849,1908,1798,7312
"2014-07-13_R17_Richmond-v-Port Adelaide",1871,2053,2074,1927,7925
"2014-07-18_R18_Carlton-v-North Melbourne",1758,1943,1656,1909,7266
"2014-07-19_R18_Greater Western Sydney-v-Geelong",1726,1681,2008,2002,7417
"2014-07-19_R18_St Kilda-v-Fremantle",2031,1780,1994,1780,7585
"2014-07-20_R18_Port Adelaide-v-Melbourne",1859,1919,1722,1798,7298
"2014-07-20_R18_Western Bulldogs-v-Essendon",1890,1769,1788,1812,7259
"2014-07-25_R18_West Coast-v-Richmond",1852,1978,1967,1932,7729
"2014-07-26_R18_Brisbane Lions-v-Gold Coast",1946,1880,1905,1694,7425
"2014-07-26_R18_Hawthorn-v-Sydney",1765,1671,2002,1842,7280
"2014-07-27_R18_Collingwood-v-Adelaide",1804,1694,1836,1947,7281
"2014-07-31_R19_Fremantle-v-Carlton",1899,1528,1798,1873,7098
"2014-08-01_R19_Sydney-v-Essendon",1856,1766,1680,1873,7175
"2014-08-02_R19_Adelaide-v-West Coast",1977,1897,2042,1794,7710
"2014-08-02_R19_Gold Coast-v-St Kilda",1749,1701,1827,1809,7086
"2014-08-02_R19_North Melbourne-v-Geelong",1810,1798,1806,1802,7216
"2014-08-02_R19_Richmond-v-Greater Western Sydney",1657,1730,1781,1706,6874
"2014-08-03_R19_Collingwood-v-Port Adelaide",1708,1898,1746,1677,7029
"2014-08-03_R19_Hawthorn-v-Western Bulldogs",1927,1590,1793,1749,7059
"2014-08-03_R19_Melbourne-v-Brisbane Lions",1747,1576,1584,1922,6829
"2014-08-08_R20_Richmond-v-Essendon",1714,1873,1687,1878,7152
"2014-08-09_R20_Carlton-v-Gold Coast",1647,2036,1649,1836,7168
"2014-08-09_R20_Geelong-v-Fremantle",1783,1723,1721,1919,7146
"2014-08-09_R20_Greater Western Sydney-v-North Melbourne",1667,2050,1820,1690,7227
"2014-08-09_R20_Hawthorn-v-Melbourne",1764,1960,1797,1780,7301
"2014-08-09_R20_Port Adelaide-v-Sydney",1716,1642,1902,1883,7143
"2014-08-10_R20_Brisbane Lions-v-Adelaide",1946,2389,1653,1954,7942
"2014-08-10_R20_St Kilda-v-Western Bulldogs",1926,1823,1776,1868,7393
"2014-08-10_R20_West Coast-v-Collingwood",2052,1842,1787,1879,7560
"2014-08-15_R21_Carlton-v-Geelong",1636,1786,1803,1720,6945
"2014-08-16_R21_Adelaide-v-Richmond",1905,1929,2183,1885,7902
"2014-08-16_R21_Collingwood-v-Brisbane Lions",1962,1673,1671,1872,7178
"2014-08-16_R21_Essendon-v-West Coast",1750,1779,1772,1654,6955
"2014-08-16_R21_Gold Coast-v-Port Adelaide",1837,1811,1885,1999,7532
"2014-08-16_R21_Sydney-v-St Kilda",1823,1640,1926,1825,7214
"2014-08-17_R21_Fremantle-v-Hawthorn",1882,2107,1755,1665,7409
"2014-08-17_R21_North Melbourne-v-Western Bulldogs",1772,1980,2010,1863,7625
"2014-08-22_R22_Port Adelaide-v-Carlton",1850,2078,1963,1882,7773
"2014-08-23_R22_Essendon-v-Gold Coast",1716,1749,1950,1879,7294
"2014-08-23_R22_Greater Western Sydney-v-Collingwood",1785,1883,2026,1880,7574
"2014-08-23_R22_Hawthorn-v-Geelong",1804,1649,1775,1757,6985
"2014-08-23_R22_North Melbourne-v-Adelaide",1834,1735,1827,2302,7698
"2014-08-23_R22_West Coast-v-Melbourne",1778,1777,1854,1728,7137
"2014-08-24_R22_Brisbane Lions-v-Fremantle",1664,1755,1568,1811,6798
"2014-08-24_R22_Richmond-v-St Kilda",1839,1645,1834,1827,7145
"2014-08-24_R22_Western Bulldogs-v-Sydney",1923,1845,1940,1720,7428
"2014-08-29_R23_Collingwood-v-Hawthorn",1692,1843,1675,1891,7101
"2014-08-30_R23_Carlton-v-Essendon",1822,1865,1710,1737,7134
"2014-08-30_R23_Fremantle-v-Port Adelaide",1882,1852,2066,1858,7658
"2014-08-30_R23_Geelong-v-Brisbane Lions",1777,2036,1853,1666,7332
"2014-08-30_R23_North Melbourne-v-Melbourne",1886,1835,1720,1955,7396
"2014-08-30_R23_Sydney-v-Richmond",1900,1801,1855,1895,7451
"2014-08-31_R23_Adelaide-v-St Kilda",1792,1803,1780,1894,7269
"2014-08-31_R23_Gold Coast-v-West Coast",2000,1710,2017,1699,7426
"2014-08-31_R23_Western Bulldogs-v-Greater Western Sydney",1767,1920,2075,1945,7707
"2014-09-05_RQualifying_Hawthorn-v-Geelong",1693,1719,1912,1944,7268
"2014-09-06_RElimination_North Melbourne-v-Essendon",1664,1820,1896,1851,7231
"2014-09-06_RQualifying_Sydney-v-Fremantle",1720,1768,1787,1965,7240
"2014-09-07_RElimination_Port Adelaide-v-Richmond",1863,1872,1862,1677,7274
"2014-09-12_RSemi_North Melbourne-v-Geelong",2106,1590,1823,1895,7414
"2014-09-13_RSemi_Port Adelaide-v-Fremantle",1862,1846,2056,2002,7766
"2014-09-19_RPreliminary_Sydney-v-North Melbourne",1796,1847,1811,1837,7291
"2014-09-20_RPreliminary_Hawthorn-v-Port Adelaide",1695,1869,1951,1907,7422
"2014-09-27_RGrand_Hawthorn-v-Sydney",1832,1911,1890,1802,7435
"2015-04-02_R1_Carlton-v-Richmond",1798,1873,1623,1833,7127
"2015-04-04_R1_Brisbane Lions-v-Collingwood",1725,1802,1920,1878,7325
"2015-04-04_R1_Melbourne-v-Gold Coast",1720,1838,1927,1888,7373
"2015-04-04_R1_Sydney-v-Essendon",1865,1881,1945,2323,8014
"2015-04-04_R1_Western Bulldogs-v-West Coast",2048,1833,1923,1846,7650
"2015-04-05_R1_Adelaide-v-North Melbourne",1749,1889,1808,1791,7237
"2015-04-05_R1_Fremantle-v-Port Adelaide",1634,1723,1727,1922,7006
"2015-04-05_R1_St Kilda-v-Greater Western Sydney",1733,1782,1759,1954,7228
"2015-04-06_R1_Hawthorn-v-Geelong",1701,1801,1855,1836,7193
"2015-04-10_R2_West Coast-v-Carlton",1894,1731,1921,1771,7317
"2015-04-11_R2_Collingwood-v-Adelaide",1788,1838,1740,2098,7464
"2015-04-11_R2_Gold Coast-v-St Kilda",1996,1914,1690,1798,7398
"2015-04-11_R2_Greater Western Sydney-v-Melbourne",1841,1850,1946,1767,7404
"2015-04-11_R2_Port Adelaide-v-Sydney",1727,1975,1832,1614,7148
"2015-04-11_R2_Richmond-v-Western Bulldogs",1751,1608,1842,1707,6908
"2015-04-12_R2_Essendon-v-Hawthorn",1668,1812,1829,1742,7051
"2015-04-12_R2_Geelong-v-Fremantle",1625,2021,1924,1561,7131
"2015-04-12_R2_North Melbourne-v-Brisbane Lions",1825,1960,1665,1650,7100
"2015-04-17_R3_Collingwood-v-St Kilda",2066,1943,1761,1787,7557
"2015-04-18_R3_Adelaide-v-Melbourne",1915,1862,2141,2054,7972
"2015-04-18_R3_Brisbane Lions-v-Richmond",1826,2022,1873,1877,7598
"2015-04-18_R3_Carlton-v-Essendon",1931,1958,1797,1974,7660
"2015-04-18_R3_North Melbourne-v-Port Adelaide",1738,1875,2039,1960,7612
"2015-04-18_R3_Sydney-v-Greater Western Sydney",1780,1950,1895,1896,7521
"2015-04-19_R3_Geelong-v-Gold Coast",1961,1987,2239,1757,7944
"2015-04-19_R3_Hawthorn-v-Western Bulldogs",1622,2035,1685,1700,7042
"2015-04-19_R3_West Coast-v-Fremantle",1889,1837,1711,1765,7202
"2015-04-24_R4_Richmond-v-Melbourne",1855,1912,1844,1771,7382
"2015-04-25_R4_Essendon-v-Collingwood",1626,1712,1717,1594,6649
"2015-04-25_R4_Fremantle-v-Sydney",1766,1777,1752,1781,7076
"2015-04-25_R4_Port Adelaide-v-Hawthorn",1988,1910,1935,1857,7690
"2015-04-25_R4_St Kilda-v-Carlton",1923,1895,1983,2114,7915
"2015-04-26_R4_Brisbane Lions-v-West Coast",1820,1964,1745,1974,7503
"2015-04-26_R4_Geelong-v-North Melbourne",1814,1698,1664,1961,7137
"2015-04-26_R4_Western Bulldogs-v-Adelaide",1921,1929,1848,1725,7423
"2015-05-01_R5_Carlton-v-Collingwood",1757,1875,1776,1685,7093
"2015-05-02_R5_Gold Coast-v-Brisbane Lions",1825,2043,2071,1694,7633
"2015-05-02_R5_North Melbourne-v-Hawthorn",2071,1533,1961,1979,7544
"2015-05-02_R5_Richmond-v-Geelong",1633,1753,1774,1781,6941
"2015-05-02_R5_Sydney-v-Western Bulldogs",1995,1866,1973,1938,7772
"2015-05-02_R5_West Coast-v-Greater Western Sydney",1811,1698,1755,1730,6994
"2015-05-03_R5_Adelaide-v-Port Adelaide",1875,1802,1934,2031,7642
"2015-05-03_R5_Melbourne-v-Fremantle",1749,1770,1696,1833,7048
"2015-05-03_R5_St Kilda-v-Essendon",1756,1908,1854,1678,7196
"2015-05-08_R6_Collingwood-v-Geelong",1745,1639,1718,1770,6872
"2015-05-09_R6_Fremantle-v-Essendon",1795,1659,1679,1643,6776
"2015-05-09_R6_Gold Coast-v-Adelaide",1785,1585,1766,1868,7004
"2015-05-09_R6_Greater Western Sydney-v-Hawthorn",1751,1827,2017,2020,7615
"2015-05-09_R6_Melbourne-v-Sydney",1688,1743,1816,1822,7069
"2015-05-09_R6_North Melbourne-v-Richmond",1714,1850,1871,1942,7377
"2015-05-09_R6_Western Bulldogs-v-St Kilda",1820,1892,1856,1833,7401
"2015-05-10_R6_Carlton-v-Brisbane Lions",1873,1784,2133,1766,7556
"2015-05-10_R6_Port Adelaide-v-West Coast",1836,1722,1769,2009,7336
"2015-05-15_R7_Essendon-v-North Melbourne",1705,1790,1849,1878,7222
"2015-05-16_R7_Adelaide-v-St Kilda",2153,1972,2058,1975,8158
"2015-05-16_R7_Hawthorn-v-Melbourne",1847,1710,1844,1849,7250
"2015-05-16_R7_Sydney-v-Geelong",1852,2012,1754,1849,7467
"2015-05-16_R7_West Coast-v-Gold Coast",1721,1739,2036,1835,7331
"2015-05-17_R7_Brisbane Lions-v-Port Adelaide",1767,1822,2103,1959,7651
"2015-05-17_R7_Richmond-v-Collingwood",1700,1910,1900,1788,7298
"2015-05-17_R7_Western Bulldogs-v-Fremantle",1720,1710,1806,1883,7119
"2015-05-22_R8_Geelong-v-Carlton",1859,1837,1981,1702,7379
"2015-05-23_R8_Fremantle-v-North Melbourne",1758,2035,1773,1659,7225
"2015-05-23_R8_Gold Coast-v-Collingwood",1769,1939,1721,1717,7146
"2015-05-23_R8_Greater Western Sydney-v-Adelaide",1869,1697,2290,1747,7603
"2015-05-23_R8_Hawthorn-v-Sydney",1708,1933,1828,1721,7190
"2015-05-23_R8_St Kilda-v-West Coast",1826,1769,2064,1802,7461
"2015-05-24_R8_Essendon-v-Brisbane Lions",2041,1827,1903,1764,7535
"2015-05-24_R8_Melbourne-v-Western Bulldogs",1792,1871,2069,1787,7519
"2015-05-24_R8_Port Adelaide-v-Richmond",1730,1973,1863,1921,7487
"2015-05-29_R9_Sydney-v-Carlton",1852,1761,2066,2046,7725
"2015-05-30_R9_Adelaide-v-Fremantle",1898,1785,2048,1944,7675
"2015-05-30_R9_Hawthorn-v-Gold Coast",1750,1895,1941,1607,7193
"2015-05-30_R9_Melbourne-v-Port Adelaide",1767,1904,1788,1830,7289
"2015-05-30_R9_Richmond-v-Essendon",1701,1605,1731,1791,6828
"2015-05-30_R9_Western Bulldogs-v-Greater Western Sydney",1942,1825,1853,1823,7443
"2015-05-31_R9_Brisbane Lions-v-St Kilda",1952,1970,1787,1863,7572
"2015-05-31_R9_Collingwood-v-North Melbourne",1759,1894,1936,1933,7522
"2015-05-31_R9_West Coast-v-Geelong",1752,1876,1956,1856,7440
"2015-06-05_R10_Fremantle-v-Richmond",1951,1797,1888,1874,7510
"2015-06-06_R10_Carlton-v-Adelaide",2109,1692,1756,1776,7333
"2015-06-06_R10_Essendon-v-Geelong",1628,1913,1846,1857,7244
"2015-06-06_R10_Gold Coast-v-Sydney",1838,1727,1685,1676,6926
"2015-06-06_R10_Port Adelaide-v-Western Bulldogs",1958,1934,1817,2018,7727
"2015-06-07_R10_Greater Western Sydney-v-Brisbane Lions",1757,1969,1829,1842,7397
"2015-06-07_R10_North Melbourne-v-West Coast",1804,1891,1923,1908,7526
"2015-06-07_R10_St Kilda-v-Hawthorn",1784,1681,1894,1799,7158
"2015-06-08_R10_Melbourne-v-Collingwood",1882,1933,1892,1579,7286
"2015-06-12_R11_Port Adelaide-v-Geelong",2042,2037,2006,1866,7951
"2015-06-13_R11_Gold Coast-v-Fremantle",1701,1679,1776,2010,7166
"2015-06-13_R11_North Melbourne-v-Sydney",1798,1733,1829,1631,6991
"2015-06-13_R11_West Coast-v-Essendon",1794,1871,1774,1871,7310
"2015-06-14_R11_Collingwood-v-Greater Western Sydney",1794,1829,1780,1930,7333
"2015-06-14_R11_St Kilda-v-Melbourne",1834,2014,1854,1644,7346
"2015-06-18_R12_Adelaide-v-Hawthorn",2022,1950,1938,1822,7732
"2015-06-19_R12_Richmond-v-West Coast",1849,1810,1731,1632,7022
"2015-06-20_R12_Carlton-v-Port Adelaide",1829,2207,1825,1906,7767
"2015-06-20_R12_Greater Western Sydney-v-North Melbourne",1884,1823,2136,1790,7633
"2015-06-20_R12_Western Bulldogs-v-Brisbane Lions",1712,1875,1931,2028,7546
"2015-06-21_R12_Geelong-v-Melbourne",1903,1870,1967,2058,7798
"2015-06-25_R13_Fremantle-v-Collingwood",1848,1958,1748,1860,7414
"2015-06-26_R13_Sydney-v-Richmond",1699,1804,2120,1685,7308
"2015-06-27_R13_Brisbane Lions-v-Adelaide",1902,1884,1828,1881,7495
"2015-06-27_R13_Hawthorn-v-Essendon",1721,1811,1753,1806,7091
"2015-06-27_R13_St Kilda-v-Western Bulldogs",1574,1637,1666,1654,6531
"2015-06-28_R13_Carlton-v-Gold Coast",1771,1766,1907,1757,7201
"2015-07-02_R14_Sydney-v-Port Adelaide",1945,1883,2126,1854,7808
"2015-07-03_R14_Collingwood-v-Hawthorn",1852,1952,1819,1739,7362
"2015-07-04_R14_Gold Coast-v-North Melbourne",1729,1794,2025,1992,7540
"2015-07-04_R14_Melbourne-v-West Coast",1811,1847,1873,1949,7480
"2015-07-04_R14_Richmond-v-Greater Western Sydney",1839,1630,1770,1854,7093
"2015-07-04_R14_Western Bulldogs-v-Carlton",1803,1691,1596,1930,7020
"2015-07-05_R14_Essendon-v-St Kilda",1696,1877,1819,1764,7156
"2015-07-05_R14_Fremantle-v-Brisbane Lions",1786,2024,1901,1876,7587
"2015-07-09_R15_Port Adelaide-v-Collingwood",1839,1884,1973,1979,7675
"2015-07-10_R15_Richmond-v-Carlton",1738,1697,1730,1618,6783
"2015-07-11_R15_Essendon-v-Melbourne",1831,1881,1841,1673,7226
"2015-07-11_R15_North Melbourne-v-Geelong",1799,2001,1960,1897,7657
"2015-07-11_R15_West Coast-v-Adelaide",1952,2069,1845,1924,7790
"2015-07-11_R15_Western Bulldogs-v-Gold Coast",1822,1644,1756,1952,7174
"2015-07-12_R15_Brisbane Lions-v-Sydney",1763,1787,1922,1721,7193
"2015-07-12_R15_Greater Western Sydney-v-St Kilda",1798,1955,1734,1759,7246
"2015-07-12_R15_Hawthorn-v-Fremantle",1901,1772,1811,1758,7242
"2015-07-17_R16_North Melbourne-v-Essendon",1654,1838,1907,1749,7148
"2015-07-18_R16_Collingwood-v-West Coast",1716,1722,1783,1845,7066
"2015-07-18_R16_Fremantle-v-Carlton",1823,1903,1888,1846,7460
"2015-07-18_R16_Geelong-v-Western Bulldogs",1713,1650,1909,1649,6921
"2015-07-18_R16_Gold Coast-v-Greater Western Sydney",1893,1823,1808,2061,7585
"2015-07-18_R16_Sydney-v-Hawthorn",1642,2045,1942,1894,7523
"2015-07-19_R16_Melbourne-v-Brisbane Lions",1770,1668,1613,1565,6616
"2015-07-19_R16_Port Adelaide-v-Adelaide",1904,2145,2144,1771,7964
"2015-07-19_R16_St Kilda-v-Richmond",1746,1784,1711,1777,7018
"2015-07-25_R17_Adelaide-v-Gold Coast",1890,1847,1898,2011,7646
"2015-07-25_R17_Brisbane Lions-v-North Melbourne",1896,1868,1834,1802,7400
"2015-07-25_R17_Essendon-v-Port Adelaide",1914,1970,1979,2051,7914
"2015-07-25_R17_Greater Western Sydney-v-Geelong",1673,1686,1739,1845,6943
"2015-07-25_R17_Richmond-v-Fremantle",1652,1849,1869,1718,7088
"2015-07-26_R17_Melbourne-v-St Kilda",1619,1601,1833,1577,6630
"2015-07-26_R17_West Coast-v-Sydney",1791,1714,1925,1784,7214
"2015-07-26_R17_Western Bulldogs-v-Collingwood",1863,1813,1742,1831,7249
"2015-07-31_R18_Hawthorn-v-Richmond",1662,1986,1712,1889,7249
"2015-08-01_R18_Carlton-v-North Melbourne",1694,1822,1809,1706,7031
"2015-08-01_R18_Collingwood-v-Melbourne",1766,1769,1729,1685,6949
"2015-08-01_R18_Geelong-v-Brisbane Lions",1740,1764,1826,1796,7126
"2015-08-01_R18_Gold Coast-v-West Coast",1683,1850,1832,1836,7201
"2015-08-01_R18_Sydney-v-Adelaide",1838,1771,1745,1822,7176
"2015-08-02_R18_Essendon-v-Western Bulldogs",1403,1892,1879,1685,6859
"2015-08-02_R18_Fremantle-v-Greater Western Sydney",1648,1682,1971,1871,7172
"2015-08-02_R18_Port Adelaide-v-St Kilda",1788,1901,1756,1865,7310
"2015-08-07_R19_Adelaide-v-Richmond",1780,1671,1742,1923,7116
"2015-08-08_R19_Brisbane Lions-v-Gold Coast",1862,1766,1952,1879,7459
"2015-08-08_R19_Collingwood-v-Carlton",1748,1813,1726,2123,7410
"2015-08-08_R19_Geelong-v-Sydney",1786,1731,1730,1720,6967
"2015-08-08_R19_West Coast-v-Hawthorn",1890,1963,1825,2031,7709
"2015-08-08_R19_Western Bulldogs-v-Port Adelaide",1819,1723,1809,1890,7241
"2015-08-09_R19_Greater Western Sydney-v-Essendon",1737,1546,1778,1954,7015
"2015-08-09_R19_Melbourne-v-North Melbourne",1782,1804,1847,1857,7290
"2015-08-09_R19_St Kilda-v-Fremantle",1830,1722,1632,1688,6872
"2015-08-14_R20_Sydney-v-Collingwood",1730,1871,1875,2019,7495
"2015-08-15_R20_Brisbane Lions-v-Carlton",1976,1742,1929,1843,7490
"2015-08-15_R20_Essendon-v-Adelaide",1848,1780,1993,1915,7536
"2015-08-15_R20_Geelong-v-Hawthorn",1824,1736,1902,1708,7170
"2015-08-15_R20_North Melbourne-v-St Kilda",1771,1781,1967,1938,7457
"2015-08-15_R20_Port Adelaide-v-Greater Western Sydney",2064,2032,1871,1942,7909
"2015-08-16_R20_Fremantle-v-West Coast",1915,1701,1805,2098,7519
"2015-08-16_R20_Richmond-v-Gold Coast",1764,1692,2033,1850,7339
"2015-08-16_R20_Western Bulldogs-v-Melbourne",1904,1814,1729,1935,7382
"2015-08-21_R21_Hawthorn-v-Port Adelaide",1776,1852,1987,1895,7510
"2015-08-22_R21_Adelaide-v-Brisbane Lions",1728,1862,1836,1840,7266
"2015-08-22_R21_Collingwood-v-Richmond",2006,1669,1822,1844,7341
"2015-08-22_R21_Gold Coast-v-Essendon",1815,1782,2173,1792,7562
"2015-08-22_R21_Greater Western Sydney-v-Sydney",2066,1640,1865,1986,7557
"2015-08-22_R21_St Kilda-v-Geelong",1878,1833,1767,1794,7272
"2015-08-23_R21_Carlton-v-Melbourne",1697,1748,1779,1602,6826
"2015-08-23_R21_North Melbourne-v-Fremantle",1853,1763,1684,1779,7079
"2015-08-23_R21_West Coast-v-Western Bulldogs",1836,2032,1888,2046,7802
"2015-08-28_R22_Geelong-v-Collingwood",1674,1708,1752,1795,6929
"2015-08-29_R22_Essendon-v-Richmond",1673,1816,1699,1641,6829
"2015-08-29_R22_Gold Coast-v-Port Adelaide",1874,1907,1797,1704,7282
"2015-08-29_R22_Hawthorn-v-Brisbane Lions",1772,1989,1875,1820,7456
"2015-08-29_R22_North Melbourne-v-Western Bulldogs",1700,1762,1770,2056,7288
"2015-08-30_R22_Adelaide-v-West Coast",1846,1821,1752,1783,7202
"2015-08-30_R22_Fremantle-v-Melbourne",1740,1831,1806,1674,7051
"2015-08-30_R22_St Kilda-v-Sydney",1652,1789,1773,1688,6902
"2015-09-04_R23_Richmond-v-North Melbourne",1715,1639,1789,2263,7406
"2015-09-05_R23_Brisbane Lions-v-Western Bulldogs",1926,1987,1967,2174,8054
"2015-09-05_R23_Geelong-v-Adelaide",1861,1787,1847,1799,7294
"2015-09-05_R23_Hawthorn-v-Carlton",1715,1767,1816,1724,7022
"2015-09-05_R23_Port Adelaide-v-Fremantle",1700,1751,1865,1839,7155
"2015-09-05_R23_Sydney-v-Gold Coast",1745,1835,1739,1883,7202
"2015-09-05_R23_West Coast-v-St Kilda",1783,1815,1792,1739,7129
"2015-09-06_R23_Collingwood-v-Essendon",1703,1973,1793,1785,7254
"2015-09-06_R23_Melbourne-v-Greater Western Sydney",1853,1869,1928,1898,7548
"2015-09-11_RQualifying_West Coast-v-Hawthorn",1804,2001,1849,1863,7517
"2015-09-12_RElimination_Adelaide-v-Western Bulldogs",1926,1797,1868,1838,7429
"2015-09-12_RQualifying_Fremantle-v-Sydney",1765,1669,1773,1794,7001
"2015-09-13_RElimination_North Melbourne-v-Richmond",1673,1954,1922,1750,7299
"2015-09-18_RSemi_Hawthorn-v-Adelaide",1860,1842,1889,1803,7394
"2015-09-19_RSemi_North Melbourne-v-Sydney",1727,1864,1792,1996,7379
"2015-09-25_RPreliminary_Hawthorn-v-Fremantle",1822,1640,1833,1785,7080
"2015-09-26_RPreliminary_West Coast-v-North Melbourne",1883,1818,2036,1751,7488
"2015-10-03_RGrand_Hawthorn-v-West Coast",1811,1844,1797,1703,7155
"2016-03-24_R1_Richmond-v-Carlton",1960,1856,1796,1831,7443
"2016-03-26_R1_Gold Coast-v-Essendon",1754,1941,1691,1673,7059
"2016-03-26_R1_Melbourne-v-Greater Western Sydney",1771,1803,1711,1750,7035
"2016-03-26_R1_North Melbourne-v-Adelaide",1736,1982,2138,1722,7578
"2016-03-26_R1_Sydney-v-Collingwood",1773,1764,1991,1923,7451
"2016-03-27_R1_Port Adelaide-v-St Kilda",1974,2042,2113,2140,8269
"2016-03-27_R1_West Coast-v-Brisbane Lions",2141,1868,1933,1930,7872
"2016-03-27_R1_Western Bulldogs-v-Fremantle",1743,1696,1649,1661,6749
"2016-03-28_R1_Geelong-v-Hawthorn",1738,2040,1942,2011,7731
"2016-04-01_R2_Collingwood-v-Richmond",1650,1612,1791,1962,7015
"2016-04-02_R2_Adelaide-v-Port Adelaide",1978,1983,2025,2003,7989
"2016-04-02_R2_Brisbane Lions-v-North Melbourne",1697,1928,1807,1963,7395
"2016-04-02_R2_Essendon-v-Melbourne",1655,1934,1628,1718,6935
"2016-04-02_R2_Fremantle-v-Gold Coast",1820,1933,1885,1770,7408
"2016-04-02_R2_St Kilda-v-Western Bulldogs",1686,1715,1661,1609,6671
"2016-04-03_R2_Carlton-v-Sydney",1729,1904,1696,1758,7087
"2016-04-03_R2_Greater Western Sydney-v-Geelong",1754,1878,1850,1674,7156
"2016-04-03_R2_Hawthorn-v-West Coast",1775,1809,1953,1648,7185
"2016-04-08_R3_Port Adelaide-v-Essendon",1887,1763,1769,1824,7243
"2016-04-09_R3_Richmond-v-Adelaide",1764,2033,1829,1626,7252
"2016-04-09_R3_St Kilda-v-Collingwood",1888,1807,1774,1790,7259
"2016-04-09_R3_Sydney-v-Greater Western Sydney",1695,1952,1746,1975,7368
"2016-04-09_R3_West Coast-v-Fremantle",1736,1647,1943,1940,7266
"2016-04-10_R3_Geelong-v-Brisbane Lions",1957,1849,1731,1893,7430
"2016-04-10_R3_North Melbourne-v-Melbourne",2131,2134,2066,2118,8449
"2016-04-10_R3_Western Bulldogs-v-Hawthorn",1592,1728,1970,2114,7404
"2016-04-15_R4_West Coast-v-Richmond",1923,1772,1766,1768,7229
"2016-04-16_R4_Adelaide-v-Sydney",1775,1755,1964,2043,7537
"2016-04-16_R4_Brisbane Lions-v-Gold Coast",1873,2122,2083,1956,8034
"2016-04-16_R4_Carlton-v-Western Bulldogs",1821,1721,1888,1622,7052
"2016-04-16_R4_Essendon-v-Geelong",1549,1666,1691,1621,6527
"2016-04-16_R4_Hawthorn-v-St Kilda",1792,1841,1708,1827,7168
"2016-04-17_R4_Collingwood-v-Melbourne",1788,1878,1795,1608,7069
"2016-04-17_R4_North Melbourne-v-Fremantle",1775,1907,1868,1838,7388
"2016-04-22_R5_Hawthorn-v-Adelaide",2053,1863,1752,1826,7494
"2016-04-23_R5_Gold Coast-v-North Melbourne",1886,1890,1637,1717,7130
"2016-04-23_R5_Port Adelaide-v-Geelong",1899,1880,1826,1817,7422
"2016-04-23_R5_Sydney-v-West Coast",1766,1639,1842,1632,6879
"2016-04-23_R5_Western Bulldogs-v-Brisbane Lions",1643,1875,1740,1734,6992
"2016-04-24_R5_Fremantle-v-Carlton",1745,1885,1646,1916,7192
"2016-04-24_R5_Melbourne-v-Richmond",1922,2004,1960,1989,7875
"2016-04-24_R5_St Kilda-v-Greater Western Sydney",1812,1835,1670,1929,7246
"2016-04-25_R5_Collingwood-v-Essendon",1827,1859,1892,1879,7457
"2016-04-29_R6_North Melbourne-v-Western Bulldogs",1676,1597,1873,1677,6823
"2016-04-30_R6_Adelaide-v-Fremantle",1698,1705,1738,1868,7009
"2016-04-30_R6_Geelong-v-Gold Coast",1941,1844,1793,1786,7364
"2016-04-30_R6_Melbourne-v-St Kilda",1795,1908,1929,1813,7445
"2016-04-30_R6_Richmond-v-Port Adelaide",1816,1808,1932,1570,7126
"2016-05-01_R6_Brisbane Lions-v-Sydney",1871,1746,1926,1799,7342
"2016-05-01_R6_Carlton-v-Essendon",1764,1476,1776,1803,6819
"2016-05-01_R6_West Coast-v-Collingwood",1862,1741,1875,1960,7438
"2016-05-06_R7_Richmond-v-Hawthorn",1767,1886,1847,1997,7497
"2016-05-07_R7_Collingwood-v-Carlton",1782,1942,1832,1733,7289
"2016-05-07_R7_Fremantle-v-Greater Western Sydney",2064,1981,1763,1769,7577
"2016-05-07_R7_Geelong-v-West Coast",1710,1943,1834,1922,7409
"2016-05-07_R7_Gold Coast-v-Melbourne",1807,1917,1983,1859,7566
"2016-05-07_R7_Sydney-v-Essendon",1684,1673,1705,1972,7034
"2016-05-07_R7_Western Bulldogs-v-Adelaide",1750,1761,1834,1774,7119
"2016-05-08_R7_Port Adelaide-v-Brisbane Lions",1971,1993,1882,1947,7793
"2016-05-08_R7_St Kilda-v-North Melbourne",1743,1638,1769,1802,6952
"2016-05-13_R8_Adelaide-v-Geelong",1756,1704,2029,1946,7435
"2016-05-14_R8_Brisbane Lions-v-Collingwood",1718,1902,1888,1808,7316
"2016-05-14_R8_Essendon-v-North Melbourne",1693,1643,2113,1615,7064
"2016-05-14_R8_Hawthorn-v-Fremantle",1738,1831,1998,1911,7478
"2016-05-14_R8_Richmond-v-Sydney",1860,1546,1746,1904,7056
"2016-05-15_R8_Carlton-v-Port Adelaide",1886,1827,1911,1764,7388
"2016-05-15_R8_Melbourne-v-Western Bulldogs",1820,1796,1852,1932,7400
"2016-05-15_R8_West Coast-v-St Kilda",2018,1793,1826,1768,7405
"2016-05-20_R9_Hawthorn-v-Sydney",1608,1846,1671,1935,7060
"2016-05-21_R9_Collingwood-v-Geelong",1748,1665,1688,1841,6942
"2016-05-21_R9_Fremantle-v-Richmond",1844,1873,1828,1766,7311
"2016-05-21_R9_Gold Coast-v-Adelaide",1667,1978,1808,1709,7162
"2016-05-21_R9_North Melbourne-v-Carlton",1896,1651,1832,1692,7071
"2016-05-21_R9_Port Adelaide-v-West Coast",1885,1837,2068,1861,7651
"2016-05-22_R9_Greater Western Sydney-v-Western Bulldogs",2076,1868,1860,1683,7487
"2016-05-22_R9_Melbourne-v-Brisbane Lions",1866,1832,1725,1889,7312
"2016-05-22_R9_St Kilda-v-Essendon",1602,1736,1983,1659,6980
"2016-05-27_R10_Sydney-v-North Melbourne",1896,1821,1875,1645,7237
"2016-05-28_R10_Adelaide-v-Greater Western Sydney",1765,1954,1891,2150,7760
"2016-05-28_R10_Brisbane Lions-v-Hawthorn",1780,2016,1783,2011,7590
"2016-05-28_R10_Essendon-v-Richmond",1865,1801,1809,1662,7137
"2016-05-28_R10_Melbourne-v-Port Adelaide",1679,1890,1842,1855,7266
"2016-05-28_R10_St Kilda-v-Fremantle",1863,1745,1826,1936,7370
"2016-05-29_R10_Carlton-v-Geelong",1808,1964,1785,1881,7438
"2016-05-29_R10_Collingwood-v-Western Bulldogs",1622,1460,1582,1744,6408
"2016-05-29_R10_West Coast-v-Gold Coast",1867,1765,1833,1796,7261
"2016-06-03_R11_North Melbourne-v-Richmond",1931,1734,2224,1836,7725
"2016-06-04_R11_Carlton-v-Brisbane Lions",1629,1795,1835,1913,7172
"2016-06-04_R11_Fremantle-v-Essendon",1720,1795,1983,1745,7243
"2016-06-04_R11_Geelong-v-Greater Western Sydney",1787,1853,1906,2062,7608
"2016-06-04_R11_Gold Coast-v-Sydney",1723,1755,1729,1798,7005
"2016-06-04_R11_Hawthorn-v-Melbourne",1800,1801,1771,1757,7129
"2016-06-05_R11_Adelaide-v-St Kilda",1778,2019,1891,1694,7382
"2016-06-05_R11_Collingwood-v-Port Adelaide",1760,1751,1613,1685,6809
"2016-06-05_R11_Western Bulldogs-v-West Coast",1729,1650,1738,1739,6856
"2016-06-10_R12_Essendon-v-Hawthorn",1877,1806,1585,1850,7118
"2016-06-11_R12_Brisbane Lions-v-Fremantle",1660,1927,1982,1790,7359
"2016-06-11_R12_Geelong-v-North Melbourne",1809,1707,1842,1897,7255
"2016-06-11_R12_Port Adelaide-v-Western Bulldogs",1911,1797,1856,1890,7454
"2016-06-11_R12_West Coast-v-Adelaide",1829,1889,1803,1831,7352
"2016-06-12_R12_Greater Western Sydney-v-Sydney",1679,1745,1829,1992,7245
"2016-06-12_R12_Richmond-v-Gold Coast",1768,1757,2075,1949,7549
"2016-06-12_R12_St Kilda-v-Carlton",1793,1823,1877,1802,7295
"2016-06-13_R12_Melbourne-v-Collingwood",1815,1831,1613,1788,7047
"2016-06-17_R13_North Melbourne-v-Hawthorn",1802,1833,1858,1963,7456
"2016-06-18_R13_Brisbane Lions-v-West Coast",1919,1842,1769,1986,7516
"2016-06-18_R13_Fremantle-v-Port Adelaide",1827,1801,2096,1659,7383
"2016-06-18_R13_Western Bulldogs-v-Geelong",1697,1667,1664,1663,6691
"2016-06-19_R13_Essendon-v-Greater Western Sydney",1851,1874,1847,1882,7454
"2016-06-19_R13_Sydney-v-Melbourne",1679,1701,1737,1912,7029
"2016-06-23_R14_Adelaide-v-North Melbourne",2021,1827,1878,1941,7667
"2016-06-24_R14_Collingwood-v-Fremantle",1819,1727,1507,1774,6827
"2016-06-25_R14_Greater Western Sydney-v-Carlton",2062,1743,1796,2120,7721
"2016-06-25_R14_Richmond-v-Brisbane Lions",1715,1680,1734,1884,7013
"2016-06-25_R14_St Kilda-v-Geelong",1757,1738,1920,1676,7091
"2016-06-26_R14_Hawthorn-v-Gold Coast",1726,1742,1715,1633,6816
"2016-06-30_R15_West Coast-v-Essendon",1750,1925,1656,1927,7258
"2016-07-01_R15_Port Adelaide-v-Richmond",1791,2097,1728,1887,7503
"2016-07-02_R15_Carlton-v-Collingwood",1732,1524,1553,1868,6677
"2016-07-02_R15_Gold Coast-v-St Kilda",1834,1677,1696,1685,6892
"2016-07-02_R15_Sydney-v-Western Bulldogs",1644,1810,1836,1702,6992
"2016-07-03_R15_Melbourne-v-Adelaide",1785,1910,1961,1769,7425
"2016-07-07_R16_Port Adelaide-v-Hawthorn",1865,2005,1920,2007,7797
"2016-07-08_R16_Geelong-v-Sydney",1796,1669,1746,1753,6964
"2016-07-09_R16_Gold Coast-v-Brisbane Lions",1987,1902,1880,1878,7647
"2016-07-09_R16_Greater Western Sydney-v-Collingwood",1866,1994,1759,1712,7331
"2016-07-09_R16_Melbourne-v-Fremantle",1927,1686,1841,1753,7207
"2016-07-09_R16_Western Bulldogs-v-Richmond",1770,1682,1663,1862,6977
"2016-07-10_R16_Carlton-v-Adelaide",1745,1811,1745,1696,6997
"2016-07-10_R16_Essendon-v-St Kilda",1764,1888,1830,1987,7469
"2016-07-10_R16_West Coast-v-North Melbourne",1781,2239,1825,1840,7685
"2016-07-14_R17_Sydney-v-Hawthorn",1813,1617,1676,1980,7086
"2016-07-15_R17_Fremantle-v-Geelong",1626,1879,1858,1940,7303
"2016-07-16_R17_Adelaide-v-Collingwood",1695,1924,1757,1727,7103
"2016-07-16_R17_North Melbourne-v-Port Adelaide",1697,1841,1715,1766,7019
"2016-07-16_R17_Richmond-v-Essendon",1695,1835,1787,1806,7123
"2016-07-16_R17_Western Bulldogs-v-Gold Coast",1850,1761,1599,1650,6860
"2016-07-17_R17_Brisbane Lions-v-Greater Western Sydney",1805,2079,2001,1762,7647
"2016-07-17_R17_Carlton-v-West Coast",1664,1786,1902,1802,7154
"2016-07-17_R17_St Kilda-v-Melbourne",1848,1755,1816,1814,7233
"2016-07-22_R18_Collingwood-v-North Melbourne",1904,1738,2009,1871,7522
"2016-07-23_R18_Geelong-v-Adelaide",1774,1831,1774,1755,7134
"2016-07-23_R18_Gold Coast-v-Fremantle",1838,1968,1734,1758,7298
"2016-07-23_R18_Sydney-v-Carlton",1945,1684,1937,1780,7346
"2016-07-23_R18_West Coast-v-Melbourne",1691,1926,1857,1740,7214
"2016-07-23_R18_Western Bulldogs-v-St Kilda",1842,1764,1710,1771,7087
"2016-07-24_R18_Essendon-v-Brisbane Lions",1837,1730,1785,1869,7221
"2016-07-24_R18_Hawthorn-v-Richmond",1684,1625,1640,1917,6866
"2016-07-24_R18_Port Adelaide-v-Greater Western Sydney",1941,1905,2031,1843,7720
"2016-07-29_R19_Geelong-v-Western Bulldogs",1895,1946,1699,1771,7311
"2016-07-30_R19_Brisbane Lions-v-Port Adelaide",1806,1820,2068,1976,7670
"2016-07-30_R19_Collingwood-v-West Coast",1681,1711,1803,1777,6972
"2016-07-30_R19_Hawthorn-v-Carlton",1707,1474,1789,1662,6632
"2016-07-30_R19_North Melbourne-v-St Kilda",1621,1654,1660,1850,6785
"2016-07-31_R19_Adelaide-v-Essendon",1868,1891,1948,1824,7531
"2016-07-31_R19_Fremantle-v-Sydney",1774,1733,1935,1976,7418
"2016-07-31_R19_Melbourne-v-Gold Coast",1604,1797,1635,1829,6865
"2016-08-05_R20_Richmond-v-Collingwood",1825,1630,1671,1877,7003
"2016-08-06_R20_Adelaide-v-Brisbane Lions",1856,2046,1884,1688,7474
"2016-08-06_R20_Gold Coast-v-Greater Western Sydney",1804,1784,1761,1666,7015
"2016-08-06_R20_Melbourne-v-Hawthorn",1835,1937,1814,1697,7283
"2016-08-06_R20_Sydney-v-Port Adelaide",1713,1786,1659,1532,6690
"2016-08-06_R20_Western Bulldogs-v-North Melbourne",1626,1620,1678,1721,6645
"2016-08-07_R20_Carlton-v-St Kilda",1660,1766,1805,1699,6930
"2016-08-07_R20_Fremantle-v-West Coast",1786,1801,1831,1688,7106
"2016-08-07_R20_Geelong-v-Essendon",1542,1688,1839,1649,6718
"2016-08-12_R21_Western Bulldogs-v-Collingwood",1733,1914,1819,1845,7311
"2016-08-13_R21_Brisbane Lions-v-Carlton",1868,1773,1859,1785,7285
"2016-08-13_R21_Greater Western Sydney-v-West Coast",1697,1988,1930,2367,7982
"2016-08-13_R21_Hawthorn-v-North Melbourne",1829,1864,1803,1589,7085
"2016-08-13_R21_Port Adelaide-v-Melbourne",1858,1825,1673,1858,7214
"2016-08-13_R21_St Kilda-v-Sydney",1828,1778,1862,1936,7404
"2016-08-14_R21_Essendon-v-Gold Coast",1592,1710,1611,1789,6702
"2016-08-14_R21_Fremantle-v-Adelaide",1739,1985,1859,1861,7444
"2016-08-14_R21_Richmond-v-Geelong",1590,1765,1724,1809,6888
"2016-08-19_R22_West Coast-v-Hawthorn",1906,1796,1868,1796,7366
"2016-08-20_R22_Collingwood-v-Gold Coast",1760,2111,1817,1580,7268
"2016-08-20_R22_North Melbourne-v-Sydney",1920,1529,1918,1571,6938
"2016-08-20_R22_Port Adelaide-v-Adelaide",1880,2174,1969,1829,7852
"2016-08-20_R22_Richmond-v-St Kilda",1722,1636,1698,1617,6673
"2016-08-21_R22_Brisbane Lions-v-Geelong",2030,1838,1749,1816,7433
"2016-08-21_R22_Carlton-v-Melbourne",1815,1671,1653,1554,6693
"2016-08-21_R22_Essendon-v-Western Bulldogs",1815,1841,1643,1596,6895
"2016-08-26_R23_Adelaide-v-West Coast",1723,1872,1790,1834,7219
"2016-08-27_R23_Essendon-v-Carlton",1649,1798,1699,1680,6826
"2016-08-27_R23_Geelong-v-Melbourne",1804,1831,1704,2027,7366
"2016-08-27_R23_Gold Coast-v-Port Adelaide",1652,1675,1871,1767,6965
"2016-08-27_R23_North Melbourne-v-Greater Western Sydney",1716,1761,1856,1833,7166
"2016-08-27_R23_Sydney-v-Richmond",1795,1866,1823,1717,7201
"2016-08-28_R23_Fremantle-v-Western Bulldogs",1825,1799,1662,1571,6857
"2016-08-28_R23_Hawthorn-v-Collingwood",1645,1931,1850,1858,7284
"2016-08-28_R23_St Kilda-v-Brisbane Lions",1896,1812,1929,2062,7699
"2016-09-08_RElimination_Western Bulldogs-v-West Coast",1795,1631,1911,1799,7136
"2016-09-09_RQualifying_Geelong-v-Hawthorn",1710,1962,1963,1719,7354
"2016-09-10_RElimination_Adelaide-v-North Melbourne",1744,1806,1994,2002,7546
"2016-09-10_RQualifying_Greater Western Sydney-v-Sydney",1939,1656,1812,1846,7253
"2016-09-16_RSemi_Western Bulldogs-v-Hawthorn",1897,1855,1977,1724,7453
"2016-09-17_RSemi_Sydney-v-Adelaide",2007,1970,1752,1896,7625
"2016-09-23_RPreliminary_Sydney-v-Geelong",1933,1815,1809,1623,7180
"2016-09-24_RPreliminary_Western Bulldogs-v-Greater Western Sydney",1713,2002,1970,1963,7648
"2016-10-01_RGrand_Western Bulldogs-v-Sydney",1682,1969,1728,1788,7167
